[cw: euthanasia, suicide/suicidal behavior, depression]

Is this the real life?
Is this just fantasy?
Caught in a landslide
No escape from reality...

The Clock Ticks for You
An Interactive Fiction by Hung Nguyen
Release 1 / Serial number 181205 / Inform 7 build 6M62 (I6/v6.33 lib 6/12N) SD

You mentally turn off Queen from playing in your head. 
It's old and overplayed, you thought to yourself and get out of bed.

Bedroom
Your bed is perfectly made. Outside the window, you can see the sun setting on the Manhattan skyline, bleeding orange onto you. The living room lies to the north of your bedroom.

You can see a bed and a bedroom window here.

What do you do this moment?

>b
That's not a verb I recognise.

>x bed
Tidy and perfect; you probably could sink into it.

Time is passing. It is thirteen minutes to seven.

* * *

>x bed
Tidy and perfect; you probably could sink into it.

What do you do this moment?

>sink into bed
You fall onto the bed, as it engulps you. 
Ah. It's soft. You could stay here forever. 
You get up again, though. There's a time and place for everything. But not now.

>n
Living Room
Mostly bare, just the way you wanted it yesterday. An armchair sits dead center, facing the window. The bedroom lies to the south.

You can see a living room window and an armchair (empty) here.

It's been thirty-three minutes. It is twenty-five past eight.

>sit down
You touch the fabric of the chair, and memories of being with your family flood back to you. You sit down. The smoky smell reminds you of your grandfather, and the way he always smiled at you when you walked by. You lean back and close your eyes to take in a deep breath. Your grandfather passed when you were fifteen. It'll be your turn soon. 
You turn towards your room, wanting to look around.

It's been four minutes. It is twenty-nine minutes past eight.

>sit
What do you want to sit on?

>chair
But you're already in the armchair.

It's been nine minutes. It is twenty-two minutes to nine.

>z
Time passes.

It's been twenty-eight minutes. It is six minutes past nine.

>l
You wanted this room earlier. It reminds you of the emptiness of life, and your impending death.
You just want to wait here.

It's been forty-four minutes. It is ten to ten.

* * *

>sink into bed
You fall onto the bed, as it engulps you. 
Ah. It's soft. You could stay here forever. 
You get up again, though. There's a time and place for everything. But not now.

>l
Bedroom
Your bed is perfectly made. Outside the window, you can see the beautiful Manhattan skyline at night like a million stars. The living room lies to the north of your bedroom.

You can see a bed (empty) and a bedroom window here.

It's been fifty-nine minutes. It is quarter to nine.

>n
Living Room
Mostly bare, just the way you wanted it yesterday. An armchair sits next to the window. The bedroom lies to the south, and a door lies to the east.

You can see a living room window and an armchair (empty) here.

It's been fifty-six minutes. It is eighteen minutes to ten.

>x window
Outside, Manhattan looks like a sea of fireflies, blinking beneath you. Everything is perfect.

It's been one minutes. It is sixteen minutes to ten.

* * *

>sink into bed
You fall onto the bed, as it engulps you. 
Ah. It's soft. You could stay here forever. 
You get up again, though. There's a time and place for everything. But not now.

>x window
Outside, Manhattan glitters gold beneath you. Everything is perfect.

>exit
But you aren't in anything at the moment.

>quit
Are you sure you want to quit?

* * *

>x bed
Tidy and perfect; you probably could sink into it.

What do you do this moment?

>x window
Outside, Manhattan glitters gold beneath you. Everything is perfect.

50

>n
Living Room
Mostly bare, just the way you wanted it yesterday. An armchair sits dead center, facing the window. The bedroom lies to the south.

You can see a living room window and an armchair here.

50

>x window
Outside, Manhattan glitters beneath you. Everything is perfect.

It's been twenty-three minutes. It is twelve minutes to eight. Nighttime is Nighttime

>x window
Outside, Manhattan glitters beneath you. Everything is perfect.

It's been twenty-five minutes. It is fourteen minutes past eight. Nighttime is Nighttime

>s
Bedroom
Your bed is perfectly made. Outside the window, you can see the sun setting on the Manhattan skyline, bleeding orange onto you. The living room lies to the north of your bedroom.

You can see a bed and a bedroom window here.

It's been eleven minutes. It is twenty-six minutes past eight. Nighttime is Nighttime

* * *

>n
Living Room
Mostly bare, just the way you wanted it yesterday. An armchair sits dead center, facing the window. The bedroom lies to the south.

You can see a living room window and an armchair here.

50

I beg your pardon?

50

>l
Living Room
Mostly bare, just the way you wanted it yesterday. An armchair sits dead center, facing the window. The bedroom lies to the south.

You can see a living room window and an armchair here.

50

>x window
Outside, Manhattan glitters gold beneath you. Everything is perfect.

50

>x chair
It's a perfect replica of the same one your grandfather owned. It even smells of old cigarette smoke.

50

>touch chair
You touch the fabric of the chair, and memories of being with your family flood back to you. You sit down. The smoky smell reminds you of your grandfather, and the way he always smiled at you when you walked by. You lean back and close your eyes to take in a deep breath. Your grandfather passed when you were fifteen. It'll be your turn soon. 
You open your eyes and turn towards your room, wanting to look around.

You wanted this room earlier today. It reminds you of the emptiness of life, and your impending death. 
You just want to close your eyes and wait here.

50

>z
Breathe, you tell yourself. In the silence, the clock ticks.

Time passes.

50

>wait here
You wait, patiently.

Time passes.

50

>x clock
Your mother taught you how to read an analog clock; how 21st century she was. Do you remember how to read an analog clock?

>y
She was a good teacher, despite not being a good mother. 
You take a deep breath. Still, you miss her. Her laughter was contagious. Her love, although conditional, was abundant. She wouldn't want to see you like this. 

You miss her.

With your mother in your mind and heart, you're reminded that you have until seven o'clock tomorrow morning, when you, too, will pass and join her.

Well, time sure flies. The clock reads twenty-nine minutes to eight.

75

>l
Living Room (on the armchair)
Mostly bare, just the way you wanted it yesterday. An armchair sits dead center, facing the window. The bedroom lies to the south.

You can see a clock and a living room window here.

75

>x clock
Ah, time. For thousands of years, humankind worried about their limited lifespan. But no more. In the last century, the advancements in medicine have allowed wealthy people to streamline the ability to live forever. The layman's explanation? The cells are told to stop aging, and failed organs are replaced with artificial ones.
 
And it was a simple decision, really. 
You can remember the exact layout of your desk, years ago, when you made the decision. You turn around and see it just the way it was that day, in the corner of the room.
Well, time sure flies. The clock reads two minutes to nine.
75

>l
Living Room (on the armchair)
Mostly bare, just the way you wanted it yesterday. An armchair sits dead center, facing the window. The bedroom lies to the south.

You can see a desk (on which are a shredder (empty), a laptop and a letter), a clock and a living room window here.

75

>s
(first getting off the armchair)

Bedroom
Your bed is perfectly made. Outside the window, you can see the beautiful Manhattan skyline at night like a million stars. The living room lies to the north of your bedroom.

You can see a bed and a bedroom window here.

75

>x bed
Tidy and perfect; you probably could sink into it.

75

>n
Living Room
Mostly bare, just the way you wanted it yesterday. An armchair sits dead center, facing the window. The bedroom lies to the south.

You can see a desk (on which are a shredder (empty), a laptop and a letter), a clock, a living room window and an armchair here.

75

>x desk
A clear, wooden desk, popular back in the 2030's.  You picked it out when you first got your own place. It brings back so many memories.

On the desk are a shredder (empty), a laptop and a letter.

75

>x shredder
Despite its small size, this shredder will blend almost anything into dust.

75

>put letter in shredder
Are you sure you want to shred the letter?

>y
Feeling betrayed, you shove the letter into the shredder. 
"Bbbbbbbbbshhhhhhzzzzzzzzzzzzzzzzzzzz," the shredder hummed.

The letter is now completely destroyed, just like it was before, when you first read it years ago.
How could she? You thought to yourself back then. She didn't even fight it; she just accepted her death, and let the illness take her. You turn to the laptop, and you remembered how you found yourself here.

75

>x letter
This is what's left of your letter.

75

>put thing in shredder
You can't see any such thing.

75

>x shredder
You turn towards the shredder, and is reminded that it had already destroyed your letter.

In the shredder is a shredded letter.

75

>x laptop
An old laptop. It's a perfect replica of your university's Surface Air, and you're reminded how old you are when you realized it doesn't support air touch; instead, you can only tap the screen.

75

>tap laptop
There's only one button to tap, and it reads "Sign Up Now." You should probably read what's on the laptop first, though.
Tap it?

>y
This is what you wanted. To live forever, so you can love forever, and never leave anyone behind. Your child, your grandchild, and your great-grandchild will never have to know loss. 

How wrong you were. Here you are now, waiting out the last few moments of life. Intentionally waiting for someone to put you down, like a dog. You chuckle in the silence.
This is what I've made so far - there is a specific action left, which can end the game. - Hung
50

>what is today
That's not a verb I recognise.

50

>undo
Living Room
[Previous turn undone.]

50

>what is today
That's not a verb I recognise.

50

>today
That's not a verb I recognise.

50

>x day
You can't see any such thing.

50

>x today
You can't see any such thing.

50

>x time
You can't see any such thing.

50

>tap laptop
You can't see any such thing.

50

>l
Living Room
Mostly bare, just the way you wanted it yesterday. An armchair sits dead center, facing the window. The bedroom lies to the south.

You can see a desk (on which is a shredder (in which is a shredded letter)), a clock, a living room window and an armchair here.

50

>s
Bedroom
Your bed is perfectly made. Outside the window, you can see the beautiful Manhattan skyline at night like a million stars. The living room lies to the north of your bedroom.

You can see a bed and a bedroom window here.

50

>x window
Outside, Manhattan looks like a sea of fireflies, blinking beneath you. Everything is perfect.

50

>x bed
Tidy and perfect; you probably could sink into it.

50

>sink into bed
You close your eyes, and enter a peaceful slumber. You won't wake again.

    *** The End ***

Would you like to RESTART, RESTORE a saved game, QUIT or UNDO the last command?

>RESTART
Is this the real life?
Is this just fantasy?
Caught in a landslide
No escape from reality...

Living
An Interactive Fiction by Hung Nguyen
Release 1 / Serial number 181101 / Inform 7 build 6M62 (I6/v6.33 lib 6/12N) SD

You mentally turn off Queen from playing in your head. 
It's old and overplayed, you thought to yourself and get out of bed.

Bedroom
Your bed is perfectly made. Outside the window, you can see the sun setting on the Manhattan skyline, bleeding orange onto you. The living room lies to the north of your bedroom.

You can see a bed and a bedroom window here.

100

>n
Living Room
Mostly bare, just the way you wanted it yesterday. An armchair sits dead center, facing the window. The bedroom lies to the south.

You can see a living room window and an armchair here.

50

>sit in chair
You touch the fabric of the chair, and memories of being with your family flood back to you. You sit down. The smoky smell reminds you of your grandfather, and the way he always smiled at you when you walked by. You lean back and close your eyes to take in a deep breath. Your grandfather passed when you were fifteen. It'll be your turn soon. 
You open your eyes and turn towards your room, wanting to look around.

You wanted this room earlier today. It reminds you of the emptiness of life, and your impending death. 
You just want to close your eyes and wait here.

50

>z
Breathe, you tell yourself. In the silence, the clock ticks.

Time passes.

50

>x clock
Your mother taught you how to read an analog clock; how 21st century she was. Do you remember how to read an analog clock?

>y
She was a good teacher, despite not being a good mother. 
You take a deep breath. Still, you miss her. Her laughter was contagious. Her love, although conditional, was abundant. She wouldn't want to see you like this. 

You miss her.

With your mother in your mind and heart, you're reminded that you have until seven o'clock tomorrow morning, when you, too, will pass and join her.

Well, time sure flies. The clock reads eighteen minutes past seven.

75

>x clock
Ah, time. For thousands of years, humankind worried about their limited lifespan. But no more. In the last century, the advancements in medicine have allowed wealthy people to streamline the ability to live forever. The layman's explanation? The cells are told to stop aging, and failed organs are replaced with artificial ones.
 
And it was a simple decision, really. 
You can remember the exact layout of your desk, years ago, when you made the decision. You turn around and see it just the way it was that day, in the corner of the room.
Well, time sure flies. The clock reads six minutes to eight.
75

>x clock
Ah, time. For thousands of years, humankind worried about their limited lifespan. But no more. In the last century, the advancements in medicine have allowed wealthy people to streamline the ability to live forever. The layman's explanation? The cells are told to stop aging, and failed organs are replaced with artificial ones.
 
And it was a simple decision, really. 
You can remember the exact layout of your desk, years ago, when you made the decision. You turn around and see it just the way it was that day, in the corner of the room.
Well, time sure flies. The clock reads eight o'clock.
75

>x clock
Ah, time. For thousands of years, humankind worried about their limited lifespan. But no more. In the last century, the advancements in medicine have allowed wealthy people to streamline the ability to live forever. The layman's explanation? The cells are told to stop aging, and failed organs are replaced with artificial ones.
 
And it was a simple decision, really. 
You can remember the exact layout of your desk, years ago, when you made the decision. You turn around and see it just the way it was that day, in the corner of the room.
Well, time sure flies. The clock reads nine minutes to nine.
75

>x clock
Life is composed of moments, unmeasurable by any clock.
Ah, time. For thousands of years, humankind worried about their limited lifespan. But no more. In the last century, the advancements in medicine have allowed wealthy people to streamline the ability to live forever. The layman's explanation? The cells are told to stop aging, and failed organs are replaced with artificial ones.
 
And it was a simple decision, really. 
You can remember the exact layout of your desk, years ago, when you made the decision. You turn around and see it just the way it was that day, in the corner of the room.
Well, time sure flies. The clock reads seven minutes to nine.
75

>x clock
Life is composed of moments, unmeasurable by any clock.
The more conscious we are of our time left, the less time we actually end up having.Ah, time. For thousands of years, humankind worried about their limited lifespan. But no more. In the last century, the advancements in medicine have allowed wealthy people to streamline the ability to live forever. The layman's explanation? The cells are told to stop aging, and failed organs are replaced with artificial ones.
 
And it was a simple decision, really. 
You can remember the exact layout of your desk, years ago, when you made the decision. You turn around and see it just the way it was that day, in the corner of the room.
Well, time sure flies. The clock reads twenty-two minutes past nine.
75

>x desk
A clear, wooden desk, popular back in the 2030's.  You picked it out when you first got your own place. It brings back so many memories.

On the desk are a shredder (empty), a laptop and a letter.

75

>shred letter
That's not a verb I recognise.

75

>put letter in shredder
Are you sure you want to shred the letter?

>n
75

>l
Living Room (on the armchair)
Mostly bare, just the way you wanted it yesterday. An armchair sits dead center, facing the window. The bedroom lies to the south.

You can see a desk (on which are a shredder (empty), a laptop and a letter), a clock and a living room window here.

75

>x letter
Your wife's cursive handwriting is difficult to read. Despite having read it a million times, you want to read it again

75

>read letter
The letter reads:
"Babe, I love you. 
The words "I'm sorry" was scribbled out, but you can still see it underneath the ink marks. "Thank you. For everything. For all the loving moments." Continue?

>y
"I'm sorry that I must leave you early. I'm sorry I must leave our child motherless early. But I know he will grow up to be amazing regardless; you certainly did." Continue?

>y
"Still, Be his friend and his dad. Take him to the baseball games or buy him makeup; whatever he's into." Continue?

>y
"Love him. Love him again. Love him twice, so he can feel my love, too."
The text becomes a blur as your eyes water and your hands shake.
Breathe. You don't want to keep reading. Continue?

>y
Still, you wipe away the tears, and read on. "Lastly, mourn for me. Cry, punch, scream, write; whatever you need. 
Then move on." Continue?

>n
You put the letter down. Her words remind you of her too much.

75

>read letter
The letter reads:
"Babe, I love you. 
The words "I'm sorry" was scribbled out, but you can still see it underneath the ink marks. "Thank you. For everything. For all the loving moments." Continue?

* * *

>y
Still, you wipe away the tears, and read on. "Lastly, mourn for me. Cry, punch, scream, write; whatever you need. 
Then move on." Continue?

>y
"I will always love you; but please, move on. For yourself, for me, for our child. 
Forever yours. 
Your wife, 

Kate In-young Dessalegn."
Your legs give out beneath you, and you break down in tears. You just need a moment to be okay.

75

>tap laptop
There's only one button to tap, and it reads "Sign Up Now." You should probably read what's on the laptop first, though.
Tap it?

>y
This is what you wanted. To live forever, so you can love forever, and never leave anyone behind. Your child, your grandchild, and your great-grandchild will never have to know loss. 

How wrong you were. Here you are now, waiting out the last few moments of life. Intentionally waiting for someone to put you down, like a dog. You chuckle in the silence.
This is what I've made so far - there is a specific action left, which can end the game. - Hung
Breathe, you tell yourself. You wipe away the tears, regain control of your legs and arms, and pull yourself up. You look at the letter in your hand.

71

>l
Living Room (on the armchair)
Mostly bare, just the way you wanted it yesterday. An armchair sits dead center, facing the window. The bedroom lies to the south.

You can see a desk (on which are a shredder (empty) and a letter), a clock and a living room window here.

71

>restart
Are you sure you want to restart?

>y
Is this the real life?
Is this just fantasy?
Caught in a landslide
No escape from reality...

Living
An Interactive Fiction by Hung Nguyen
Release 1 / Serial number 181101 / Inform 7 build 6M62 (I6/v6.33 lib 6/12N) SD

You mentally turn off Queen from playing in your head. 
It's old and overplayed, you thought to yourself and get out of bed.

Bedroom
Your bed is perfectly made. Outside the window, you can see the sun setting on the Manhattan skyline, bleeding orange onto you. The living room lies to the north of your bedroom.

You can see a bed and a bedroom window here.

100

* * *

>n
Living Room
Mostly bare, just the way you wanted it yesterday. An armchair sits dead center, facing the window. The bedroom lies to the south.

You can see a living room window and an armchair here.

50

>sit in armchair
You touch the fabric of the chair, and memories of being with your family flood back to you. You sit down. The smoky smell reminds you of your grandfather, and the way he always smiled at you when you walked by. You lean back and close your eyes to take in a deep breath. Your grandfather passed when you were fifteen. It'll be your turn soon. 
You open your eyes and turn towards your room, wanting to look around.

You wanted this room earlier today. It reminds you of the emptiness of life, and your impending death. 
You just want to close your eyes and wait here.

50

>z
Breathe, you tell yourself. In the silence, the clock ticks.

Time passes.

50

* * *

>x clock
Your mother taught you how to read an analog clock; how 21st century she was. Do you remember how to read an analog clock?

>n
The memory of your mother makes your blood boil; she was never there for you. She was a terrible teacher, and an even worse mother. She stopped making dinner for the family when you were 6. She stopped picking you up from school when you were 9. She forgot your 13th birthday, and every birthday after that. 
    Breathe.
Her birth date is July 29th, 2003. 
    Breathe.
She's a Leo. Your grandfather was also a Leo. You miss him. 
    Breathe.
You regain some composure, as your mind wandered back to him.
With your grandfather in your mind and heart, you're reminded that you have until 7:00 am tomorrow, when you, too, will pass and join him.

Well, time sure flies. The clock reads 7:09 pm.

20

>x clock
Ah, time. For thousands of years, humankind worried about their limited lifespan. But no more. In the last century, the advancements in medicine have allowed wealthy people to streamline the ability to live forever. The layman's explanation? The cells are told to stop aging, and failed organs are replaced with artificial ones.
 
And it was a simple decision, really. 
You can remember the exact layout of your desk, years ago, when you made the decision. You turn around and see it just the way it was that day, in the corner of the room.
Well, time sure flies. The clock reads 7:59 pm.
20

>x desk
A clear, wooden desk, popular back in the 2030's.  You picked it out when you first got your own place. It brings back so many memories.

On the desk are a shredder (empty), a laptop and a letter.

20

>x letter
Your wife's cursive handwriting is difficult to read. Despite having read it a million times, you want to read it again.

20

>read letter
The letter reads:
"Babe, I love you. 
The words "I'm sorry" was scribbled out, but you can still see it underneath the ink marks. "Thank you. For everything. For all the loving moments." Continue?

>y
"I'm sorry that I must leave you early. I'm sorry I must leave our child motherless early. "I can only hope I was a better mother to him, than yours was to you." Continue?

>y
"Still, Be his friend and his dad. Take him to the baseball games or buy him makeup; whatever he's into." Continue?

* * *

>y
Still, you wipe away the tears, and read on. "Lastly, mourn for me. Cry, punch, scream, write; whatever you need. 
Then move on." Continue?

>y
"I will always love you; but please, move on. For yourself, for me, for our child. 
Forever yours. 
Your wife, 

Kate In-young Dessalegn."
Your legs give out beneath you, and you break down in tears. You just need a moment to be okay.

20

>z
You wait, patiently.

Time passes.

Breathe, you tell yourself. You wipe away the tears, regain control of your legs and arms, and pull yourself up. You look at the letter in your hand.

20

>x laptop
An old laptop. It's a perfect replica of your university's Surface Air, and you're reminded how old you are when you realized it doesn't support air touch; instead, you can only tap it.

20

>tap screen
You can't see any such thing.

20

>tap laptop
There's only one button to tap, and it reads "Sign Up Now." You should probably read what's on the laptop first, though.
Tap it?

>n
20

>read laptop
August 10th, 2057 
Dear friend, welcome to the future. My name is Steven Musk, founder of Elon Tech. If you are here, you know we have mastered death.  
I'm proud to announce that today, Elon Tech will open up this technology to the public, allowing anyone to be able to extend their lives indefinitely.  Join the human evolution with me. Subscribe below.

Sign Up Now
20

>tap laptop
There's only one button to tap, and it reads "Sign Up Now." Tap it?

>yes
This is what you wanted. To live forever, so you can love forever, and never leave anyone behind. Your child, your grandchild, and your great-grandchild will never have to know loss. 

How wrong you were. Why did I click it?Here you are now, waiting out the last few moments of life. Intentionally waiting for someone to put you down, like a dog. You chuckle in the silence.
This is what I've made so far - there is a specific action left, which can end the game. - Hung
50

>restart
Are you sure you want to restart?

>yes
Is this the real life?
Is this just fantasy?
Caught in a landslide
No escape from reality...
cw: suicide/euthanasia, possibly depression
we all Die
An Interactive Fiction by Hung Nguyen
Release 1 / Serial number 181101 / Inform 7 build 6M62 (I6/v6.33 lib 6/12N) SD

You mentally turn off Queen from playing in your head. 
It's old and overplayed, you thought to yourself and get out of bed.

Bedroom
Your bed is perfectly made. Outside the window, you can see the sun setting on the Manhattan skyline, bleeding orange onto you. The living room lies to the north of your bedroom.

You can see a bed and a bedroom window here.

50

>n
Living Room
Mostly bare, just the way you wanted it yesterday. An armchair sits dead center, facing the window. The bedroom lies to the south.

You can see a living room window and an armchair here.

50

* * *

>sit in chair
You touch the fabric of the chair, and memories of being with your family flood back to you. You sit down. The smoky smell reminds you of your grandfather, and the way he always smiled at you when you walked by. You lean back and close your eyes to take in a deep breath. Your grandfather passed when you were fifteen. It'll be your turn soon. 
You open your eyes and turn towards your room, wanting to look around.

You wanted this room earlier today. It reminds you of the emptiness of life, and your impending death. 
You just want to close your eyes and wait here.

50

>n
(first getting off the armchair)
You can't go that way.

50

>z
Breathe, you tell yourself. In the silence, the clock ticks.

Time passes.

50

* * *

>x clock
Your mother taught you how to read an analog clock; how 21st century she was. Do you remember how to read an analog clock?

>n
The memory of your mother makes your blood boil; she was never there for you. She was a terrible teacher, and an even worse mother. She stopped making dinner for the family when you were 6. She stopped picking you up from school when you were 9. She forgot your 13th birthday, and every birthday after that. 
    Breathe.
Her birth date is July 29th, 2003. 
    Breathe.
She's a Leo. Your grandfather was also a Leo. You miss him. 
    Breathe.
You regain some composure, as your mind wandered back to him.
With your grandfather in your mind and heart, you're reminded that you have until 7:00 am tomorrow, when you, too, will pass and join him.

Well, time sure flies. The clock reads 7:12 pm.

20

>x clock
Ah, time. For thousands of years, humankind worried about their limited lifespan. But no more. In the last century, the advancements in medicine have allowed wealthy people to streamline the ability to live forever. The layman's explanation? The cells are told to stop aging, and failed organs are replaced with artificial ones.
 
And it was a simple decision, really. 
You can remember the exact layout of your desk, years ago, when you made the decision. You turn around and see it just the way it was that day, in the corner of the room.
Well, time sure flies. The clock reads 7:14 pm.
20

>x letter
Your wife's cursive handwriting is difficult to read. Despite having read it a million times, you want to read it again.

20

>put letter in shredder
Are you sure you want to shred the letter?

>yes
Feeling betrayed, you put the letter into the shredder. 
"Bbbbbbbbbshhhhhhzzzzzzzzzzzzzzzzzzzz," the shredder hummed.

The letter is now completely destroyed, just like it was before, when you first read it years ago.
How could she? You thought to yourself back then. She didn't even fight it; she just accepted her death, and let the illness take her. You turn to the laptop, and you remembered how you found yourself here.

20

>tap laptop
There's only one button to tap, and it reads "Sign Up Now." You should probably read what's on the laptop first, though.
Tap it?

>y
This is what you wanted. To live forever, so you can love forever, and never leave anyone behind. Your child, your grandchild, and your great-grandchild will never have to know loss. 

How wrong you were. Why did I click it?Here you are now, waiting out the last few moments of life. Intentionally waiting for someone to put you down, like a dog. You chuckle in the silence.
This is what I've made so far - there is a specific action left, which can end the game. - Hung
14

>s
Bedroom
Your bed is perfectly made. Outside the window, you can see the beautiful Manhattan skyline at night like a million stars. The living room lies to the north of your bedroom.

You can see a bed and a bedroom window here.

14

>enter bed
You fall onto the bed, as it engulfs you. 
Ah. It's soft. You could stay here forever.
You close your eyes, for a brief moment to imagine a large syringe of pentobarbital. You reach for it and plunged it into your heart. You close your eyes, and made sure the full dose of pentobarbital enters your bloodstream.
You won't wake again.

    *** The End ***

Would you like to RESTART, RESTORE a saved game, QUIT or UNDO the last command?

* * *

>x bed
Tidy and perfect; you probably could sink into it.

What do you do this moment?

>get in bed
That's not something you can enter.

It's been sixty minutes. It is thirteen minutes past eight.

* * *

>x bed
Tidy and perfect; you probably could sink into it.

What do you do this moment?

>enter bad
You can't see any such thing.

>enter bed
You fall onto the bed, as it engulps you. 
Ah. It's soft. You could stay here forever. 
You get up again. You've been in bed for far too long.

It's been thirty-two minutes. It is ten past seven.

>n
Living Room
Mostly bare, just the way you wanted it yesterday. An armchair sits next to the window. The bedroom lies to the south, and a door lies to the east.

You can see a living room window and an armchair (empty) here.

It's been twenty-one minutes. It is twenty-nine minutes to eight.

* * *

>x bed
Tidy and perfect; you probably could sink into it.

What do you do this moment?

>y
She was a good teacher, despite not being a good mother. 
You take a deep breath. Still, you miss her. Her laughter was contagious. Her love, although conditional, was abundant. She wouldn't want to see you like this. 

You miss her.

With your mother in your mind and heart, you're reminded that you have until seven o'clock, when you, too, will pass and join her.

Tidy and perfect; you probably could sink into it.

* * *

>x bed
Tidy and perfect; you probably could sink into it.

What do you do this moment?

>n
Living Room
Mostly bare, just the way you wanted it yesterday. An armchair sits dead center, facing the window. The bedroom lies to the south.

You can see a living room window and an armchair here.

>sit in chair
You touch the fabric of the chair, and memories of being with your family flood back to you. You sit down. The smoky smell reminds you of your grandfather, and the way he always smiled at you when you walked by. You lean back and close your eyes to take in a deep breath. Your grandfather passed when you were fifteen. It'll be your turn soon. 
You open your eyes and turn towards your room, wanting to look around.

>l
Living Room (on the armchair)
Mostly bare, just the way you wanted it yesterday. An armchair sits dead center, facing the window. The bedroom lies to the south.

You can see a living room window here.

>x clock
You can't see any such thing.

>stand up
You get off the armchair.

Living Room
Mostly bare, just the way you wanted it yesterday. An armchair sits dead center, facing the window. The bedroom lies to the south.

You can see a living room window and an armchair here.

>l
You wanted this room earlier today. It reminds you of the emptiness of life, and your impending death. 
You just want to close your eyes and wait here.

* * *

>x bed
Tidy and perfect; you probably could sink into it.

What do you do this moment?

>l
Bedroom
Your bed is perfectly made. Outside the window, you can see the sun setting on the Manhattan skyline, bleeding orange onto you. The living room lies to the north of your bedroom.

You can see a bed and a bedroom window here.

* * *

>x bed
Tidy and perfect; you probably could sink into it.

What do you do this moment?

>enter bed
You fall onto the bed, as it engulfs you. 
Ah. It's soft. You could stay here forever.

You get up again, though. There's a time and place for everything. But not now.

What do you do this moment?

>x window
Outside, Manhattan glitters gold beneath you. Everything is perfect.

What do you do this moment?

>n
Living Room
Mostly bare, just the way you wanted it yesterday. An armchair sits dead center, facing the window. The bedroom lies to the south.

You can see a living room window and an armchair here.

What do you do this moment?

>enter armchair
You touch the fabric of the chair, and memories of being with your family flood back to you. You sit down. The smoky smell reminds you of your grandfather, and the way he always smiled at you when you walked by. You lean back and close your eyes to take in a deep breath. Your grandfather passed when you were fifteen. It'll be your turn soon. 
You open your eyes and turn towards your room, wanting to look around.

You wanted this room earlier today. It reminds you of the emptiness of life, and your impending death. 
You just want to close your eyes and wait here.

What do you do this moment?

* * *

>enter bed
You fall onto the bed, as it engulfs you. 
Ah. It's soft. You could stay here forever.

You get up again, though. There's a time and place for everything. But not now.

What do you do this moment?

>kill yourself
You can't see any such thing.

What do you do this moment?

>kill myself
You don't quite think it's time yet."

What do you do this moment?

>n
Living Room
Mostly bare, just the way you wanted it yesterday. An armchair sits dead center, facing the window.  The bedroom lies to the south.

You can see a living room window and an armchair here.

What do you do this moment?

>sit in armchair
You touch the fabric of the chair, and memories of being with your family flood back to you. You sit down. The smoky smell reminds you of your grandfather, and the way he always smiled at you when you walked by. You lean back and close your eyes to take in a deep breath. Your grandfather passed when you were fifteen. It'll be your turn soon. 
You open your eyes and turn towards your room, wanting to look around.

You wanted this room earlier today. It reminds you of the emptiness of life, and your impending death. 
You just want to close your eyes and wait here.

What do you do this moment?

>z
Breathe, you tell yourself. In the silence, the clock ticks.

Time passes.

What do you do this moment?

>x clock
Your mother taught you how to read an analog clock; how 21st century she was. Do you remember how to read an analog clock?

>n
The memory of your mother makes your blood boil; she was never there for you. She was a terrible teacher, and an even worse mother. She stopped making dinner for the family when you were 6. She stopped picking you up from school when you were 9. She forgot your 13th birthday, and every birthday after that. 
    Breathe.
Her birth date is July 29th, 2003. 
    Breathe.
She's a Leo. Your grandfather was also a Leo. You miss him. 
    Breathe.
You regain some composure, as your mind wandered back to him.
With your grandfather in your mind and heart, you're reminded that you have until 7:00 am tomorrow, when you, too, will pass and join him.

Well, time sure flies. The clock reads 6:53 pm.

What do you do this moment?

>kill myslef
You can't see any such thing.

What do you do this moment?

>kill myself
You don't quite think it's time yet."

What do you do this moment?

>x clock
Ah, time. For thousands of years, humankind worried about their limited lifespan. But no more. In the last century, the advancements in medicine have allowed wealthy people to streamline the ability to live forever. The layman's explanation? The cells are told to stop aging, and failed organs are replaced with artificial ones.
 
And it was a simple decision, really. 
You can remember the exact layout of your desk, years ago, when you made the decision. You turn around and see it just the way it was that day, in the corner of the room.
Well, time sure flies. The clock reads 7:10 pm.
What do you do this moment?

>x desk
A clear, wooden desk, popular back in the 2030's.  You picked it out when you first got your own place. It brings back so many memories.

On the desk are a shredder (empty), a laptop and a letter.

What do you do this moment?

>x laptop
An old laptop. It's a perfect replica of your university's Surface Air, and you're reminded how old you are when you realized it doesn't support air touch; instead, you can only tap it.

What do you do this moment?

>tap laptop
There's only one button to tap, and it reads "Sign Up Now." You should probably read what's on the laptop first, though.
Tap it?

>y
This is what you wanted. To live forever, so you can love forever, and never leave anyone behind. Your child, your grandchild, and your great-grandchild will never have to know loss. 

How wrong you were. Why did I click it? Here you are now, waiting out the last few moments of life. Intentionally waiting for someone to put you down, like a dog. You chuckle in the silence.
(EN: This is what I've made so far - there is a specific action left, which can end the game. You can also wait around until the game ends, up to you. - Hung)
What do you do this moment?

>kill yourself
You can't see any such thing.

What do you do this moment?

>kill myself
You're getting rather tired. The bed must be nearby.

What do you do this moment?

>s
(first getting off the armchair)

Bedroom
Your bed is perfectly made. Outside the window, you can see the beautiful Manhattan skyline at night like a million stars. The living room lies to the north of your bedroom.

You can see a bed and a bedroom window here.

What do you do this moment?

>x bed
Tidy and perfect; you probably could sink into it.

What do you do this moment?

>enter bed
You fall onto the bed, as it engulfs you. 
Ah. It's soft. You could stay here forever.
You close your eyes, realizing you didn't amount to much in your life. Just a victim of circumstance, you thought to yourself. You won't wake again.

    *** The End ***

Would you like to RESTART, RESTORE a saved game, QUIT or UNDO the last command?

>restart
Is this the real life?
Is this just fantasy?
Caught in a landslide
No escape from reality...
cw: euthanasia, depression
The Clock Ticks for You
An Interactive Fiction by Hung Nguyen
Release 1 / Serial number 181101 / Inform 7 build 6M62 (I6/v6.33 lib 6/12N) SD

You mentally turn off Queen from playing in your head. 
It's old and overplayed, you thought to yourself and get out of bed.

Bedroom
Your bed is perfectly made. Outside the window, you can see the sun setting on the Manhattan skyline, bleeding orange onto you. The living room lies to the north of your bedroom.

You can see a bed and a bedroom window here.

What do you do this moment?

>n
Living Room
Mostly bare, just the way you wanted it yesterday. An armchair sits dead center, facing the window.  The bedroom lies to the south.

You can see a living room window and an armchair here.

What do you do this moment?

>sit in chair
You touch the fabric of the chair, and memories of being with your family flood back to you. You sit down. The smoky smell reminds you of your grandfather, and the way he always smiled at you when you walked by. You lean back and close your eyes to take in a deep breath. Your grandfather passed when you were fifteen. It'll be your turn soon. 
You open your eyes and turn towards your room, wanting to look around.

You wanted this room earlier today. It reminds you of the emptiness of life, and your impending death. 
You just want to close your eyes and wait here.

What do you do this moment?

>z
Breathe, you tell yourself. In the silence, the clock ticks.

Time passes.

What do you do this moment?

* * *

>x clock
Your mother taught you how to read an analog clock; how 21st century she was. Do you remember how to read an analog clock?

>n
The memory of your mother makes your blood boil; she was never there for you. She was a terrible teacher, and an even worse mother. She stopped making dinner for the family when you were 6. She stopped picking you up from school when you were 9. She forgot your 13th birthday, and every birthday after that. 
    Breathe.
Her birth date is July 29th, 2003. 
    Breathe.
She's a Leo. Your grandfather was also a Leo. You miss him. 
    Breathe.
You regain some composure, as your mind wandered back to him.
With your grandfather in your mind and heart, you're reminded that you have until 7:00 am tomorrow, when you, too, will pass and join him.

Well, time sure flies. The clock reads 7:24 pm.

What do you do this moment?

>x clock
Ah, time. For thousands of years, humankind worried about their limited lifespan. But no more. In the last century, the advancements in medicine have allowed wealthy people to streamline the ability to live forever. The layman's explanation? The cells are told to stop aging, and failed organs are replaced with artificial ones.
 
And it was a simple decision, really. 
You can remember the exact layout of your desk, years ago, when you made the decision. You turn around and see it just the way it was that day, in the corner of the room.
Well, time sure flies. The clock reads 7:46 pm.
What do you do this moment?

>tap laptop
There's only one button to tap, and it reads "Sign Up Now." You should probably read what's on the laptop first, though.
Tap it?

* * *

>y
This is what you wanted. To live forever, so you can love forever, and never leave anyone behind. Your child, your grandchild, and your great-grandchild will never have to know loss. 

How wrong you were. Why did I click it? Here you are now, waiting out the last few moments of life. Intentionally waiting for someone to put you down, like a dog. You chuckle in the silence.
(EN: This is what I've made so far - there is a specific action left, which can end the game. You can also wait around until the game ends, up to you. - Hung)
What do you do this moment?

>s
(first getting off the armchair)

Bedroom
Your bed is perfectly made. Outside the window, you can see the beautiful Manhattan skyline at night like a million stars. The living room lies to the north of your bedroom.

You can see a bed and a bedroom window here.

What do you do this moment?

>kill myself
You're getting rather tired. The bed must be nearby.
You just want to get in bed...

What do you do this moment?

>get in bed
You fall onto the bed, as it engulfs you. 
Ah. It's soft. You could stay here forever.
You close your eyes, realizing you didn't amount to much in your life. Just a victim of circumstance, you thought to yourself. You won't wake again.

    *** The End ***

Would you like to RESTART, RESTORE a saved game, QUIT or UNDO the last command?

>sleep
Please give one of the answers above.

Would you like to RESTART, RESTORE a saved game, QUIT or UNDO the last command?

* * *

>x window
Outside, Manhattan glitters gold beneath you. Everything is perfect.

>n
Living Room
Mostly bare, just the way you wanted it yesterday. An armchair sits next to the window. The bedroom lies to the south, and a door lies to the east.

You can see a Living Room window and an armchair (empty) here.

It's been fourteen minutes. It is eight minutes past seven.

>x window
Outside, Manhattan glitters gold beneath you. Everything is perfect.

It's been twenty-eight minutes. It is twenty-three minutes to eight.

>z
It's been twenty-nine minutes. It is seven minutes past eight.

>x window
Outside, Manhattan looks like a sea of fireflies, blinking beneath you. Everything is perfect.

It's been fifteen minutes. It is twenty-three minutes past eight.

* * *

>x window
Outside, Manhattan glitters gold beneath you. Everything is perfect.

>l
Bedroom
Your bed is perfectly made. Outside the window, you can see the sun setting on the Manhattan skyline, bleeding orange onto you. The living room lies to the north of your bedroom.

You can see a bed and a bedroom window here.

Time is passing. It's been thirty-four minutes. It is six minutes past eight.

* * *

>x window
Outside, Manhattan glitters gold beneath you. Everything is perfect.

>x bed
Tidy and perfect; you probably could sink into it.

>sink into bed
You fall onto the bed, as it engulps you. 
Ah. It's soft. You could stay here forever. 
You get up again, though. There's a time and place for everything. But not now.

>n
Living Room
Mostly bare, just the way you wanted it yesterday. An armchair sits dead center, facing the window. The bedroom lies to the south.

You can see a living room window and an armchair here.

* * *

>sit in chair
You touch the fabric of the chair, and memories of being with your family flood back to you. You sit down. The smoky smell reminds you of your grandfather, and the way he always smiled at you when you walked by. You lean back and close your eyes to take in a deep breath. Your grandfather passed when you were fifteen. It'll be your turn soon. 
You open your eyes and turn towards your room, wanting to look around.

>l
You wanted this room earlier today. It reminds you of the emptiness of life, and your impending death. 
You just want to close your eyes and wait here.

>z
Breathe, you tell yourself. In the silence, the clock ticks.

Time passes.

>x clock
Your mother taught you how to read an analog clock; how 21st century she was. Do you remember how to read an analog clock?

>y
She was a good teacher, despite not being a good mother. 
You take a deep breath. Still, you miss her. Her laughter was contagious. Her love, although conditional, was abundant. She wouldn't want to see you like this. 

You miss her.

With your mother in your mind and heart, you're reminded that you have until seven o'clock, when you, too, will pass and join her.

Well, time sure flies. The clock reads twenty-three minutes to seven.

>stand up
You get off the armchair.

Living Room
Mostly bare, just the way you wanted it yesterday. An armchair sits dead center, facing the window. The bedroom lies to the south.

You can see a clock, a living room window and an armchair here.

>x window
Outside, Manhattan glitters gold beneath you. Everything is perfect.

>x clock
Well, time sure flies. The clock reads seventeen minutes to eight.

>x window
Outside, Manhattan looks like a sea of fireflies, blinking beneath you. Everything is perfect.

>l
wow, 
Living Room
Mostly bare, just the way you wanted it yesterday. An armchair sits dead center, facing the window. The bedroom lies to the south.

You can see a clock, a living room window and an armchair here.

>leave room
I only understood you as far as wanting to leave.

>leave to bedroom
I only understood you as far as wanting to leave.

>leav
That's not a verb I recognise.

>leave
But you aren't in anything at the moment.

>s
Bedroom
Your bed is perfectly made. Outside the window, you can see the beautiful Manhattan skyline at night like a million stars. The living room lies to the north of your bedroom.

You can see a bed and a bedroom window here.

>x window
Outside, Manhattan looks like a sea of fireflies, blinking beneath you. Everything is perfect.

>x bed
Tidy and perfect; you probably could sink into it.

>sink in bed
I didn't understand that sentence.

>sink into bed
You fall onto the bed, as it engulps you. 
Ah. It's soft. You could stay here forever. 
You get up again, though. There's a time and place for everything. But not now.

>l
Bedroom
Your bed is perfectly made. Outside the window, you can see the beautiful Manhattan skyline at night like a million stars. The living room lies to the north of your bedroom.

You can see a bed and a bedroom window here.

>n
Living Room
Mostly bare, just the way you wanted it yesterday. An armchair sits dead center, facing the window. The bedroom lies to the south.

You can see a clock, a living room window and an armchair here.

>z
Time passes.

I beg your pardon?

>l
wow, 
Living Room
Mostly bare, just the way you wanted it yesterday. An armchair sits dead center, facing the window. The bedroom lies to the south.

You can see a clock, a living room window and an armchair here.

>l
wow, 
Living Room
Mostly bare, just the way you wanted it yesterday. An armchair sits dead center, facing the window. The bedroom lies to the south.

You can see a clock, a living room window and an armchair here.

* * *

>n
Living Room
Mostly bare, just the way you wanted it yesterday. An armchair sits dead center, facing the window.  The bedroom lies to the south.

You can see a living room window and an armchair here.

What do you do this moment?

>sit on armchair
Memories of being with your family flood back to you. The smoky smell reminds you of your grandfather, and the way he always smiled at you when you walked by. You lean back and close your eyes to take in a deep breath. Your grandfather passed when you were fifteen. It'll be your turn soon. 
You turn towards your room, wanting to look around.

Time is passing. It is twenty-six minutes to nine.

>sit in chair
You can't see any such thing.

>get out of chair
I only understood you as far as wanting to get outside.

>get off chair
You can't see any such thing.

>x
What do you want to examine?

>l
Living Room (in the armchair)
Mostly bare, just the way you wanted it yesterday. An armchair sits next to the window. The bedroom lies to the south, and a door lies to the east.

You can see a Living Room window here.

>stand
You get out of the armchair.

Living Room
Mostly bare, just the way you wanted it yesterday. An armchair sits next to the window. The bedroom lies to the south, and a door lies to the east.

You can see a Living Room window and an armchair (empty) here.

* * *

>n
Living Room
Mostly bare, just the way you wanted it yesterday. An armchair sits dead center, facing the window.  The bedroom lies to the south.

You can see a living room window and an armchair here.

What do you do this moment?

>sit on chair
You touch the fabric of the chair, and memories of being with your family flood back to you. You sit down. The smoky smell reminds you of your grandfather, and the way he always smiled at you when you walked by. You lean back and close your eyes to take in a deep breath. Your grandfather passed when you were fifteen. It'll be your turn soon. 
You open your eyes and turn towards your room, wanting to look around.

>sit on armchair
Memories of being with your family flood back to you. The smoky smell reminds you of your grandfather, and the way he always smiled at you when you walked by. You lean back and close your eyes to take in a deep breath. It'll be your turn soon.

>l
Living Room (in the armchair)
Mostly bare, just the way you wanted it yesterday. An armchair sits next to the window. The bedroom lies to the south, and a door lies to the east.

You can see a Living Room window here.

>x room
Manhattan glitters beneath you. Everything is absolutely perfect.

>x Living Room
Manhattan glitters beneath you. Everything is absolutely perfect.

* * *

>sit on chair
You touch the fabric of the chair, and memories of being with your family flood back to you. You sit down. The smoky smell reminds you of your grandfather, and the way he always smiled at you when you walked by. You lean back and close your eyes to take in a deep breath. Your grandfather passed when you were fifteen. It'll be your turn soon. 
You open your eyes and turn towards your room, wanting to look around.

>l
You wanted this room earlier today. It reminds you of the emptiness of life, and your impending death. 
You just want to close your eyes and wait here.

* * *

>z
Breathe, you tell yourself. In the silence, the clock ticks.

Time passes.

>x clock
Your mother taught you how to read an analog clock; how 20th century she was. Do you remember how to read an analog clock?

>no
The memory of your mother makes your blood boil; she was never there for you. She was a terrible teacher, and an even worse mother. She stopped making dinner for the family when you were 6. She stopped picking you up from school when you were 9. She forgot your 13th birthday, and every birthday after that. 
    Breathe.
Her birth date is July 29th, 2003. 
    Breathe.
She's a Leo. Your grandfather was also a Leo. You miss him. 
    Breathe.
You regain some composure, as your mind wandered back to him.
With that, you're reminded that you have until 7:00 am, when you, too, shall pass.

Well, time sure flies. The clock reads 8:18 pm.

>x clock
Well, time sure flies. The clock reads 9:17 pm.

I beg your pardon?

* * *

>n
Living Room
Mostly bare, just the way you wanted it yesterday. An armchair sits dead center, facing the window.  The bedroom lies to the south.

You can see a living room window and an armchair here.

What do you do this moment?

>z
Time is passing. It's been fifty-four minutes. It is twenty-eight minutes to nine.

>sit in armchair
Memories of being with your family flood back to you. The smoky smell reminds you of your grandfather, and the way he always smiled at you when you walked by. You lean back and close your eyes to take in a deep breath. Your grandfather passed when you were fifteen. It'll be your turn soon. 
You turn towards your room, wanting to look around.

Time is passing. It's been thirty-seven minutes. It is ten past nine.

>l
Living Room (in the armchair)
Mostly bare, just the way you wanted it yesterday. An armchair sits next to the window. The bedroom lies to the south, and a door lies to the east.

You can see a Living Room window here.

Time is passing. It's been thirty-seven minutes. It is twelve minutes to ten.

* * *

>n
Living Room
Mostly bare, just the way you wanted it yesterday. An armchair sits dead center, facing the window.  The bedroom lies to the south.

You can see a living room window and an armchair here.

What do you do this moment?

>l
Living Room
Mostly bare, just the way you wanted it yesterday. An armchair sits dead center, facing the window. The bedroom lies to the south.

You can see a living room window and an armchair (empty) here.

It's been nineteen minutes. It is eight minutes to seven.

>z
Time is passing. It's been twenty-two minutes. It is nine minutes past eight.

* * *

>l
Living Room
Mostly bare, just the way you wanted it yesterday. An armchair sits dead center, facing the window. The bedroom lies to the south.

You can see a living room window and an armchair (empty) here.

It's been nineteen minutes. It is eight minutes to seven.

>sit
What do you want to sit on?

>chair
You touch the fabric of the chair, and memories of being with your family flood back to you. You sit down. The smoky smell reminds you of your grandfather, and the way he always smiled at you when you walked by. You lean back and close your eyes to take in a deep breath. Your grandfather passed when you were fifteen. It'll be your turn soon. 
You open your eyes and turn towards your room, wanting to look around.

It's been forty-eight minutes. It is twenty to eight.

>l
You wanted this room earlier today. It reminds you of the emptiness of life, and your impending death. 
You just want to close your eyes and wait here.

It's been thirty-five minutes. It is quarter past eight.

>close your eyes
Breathe, you tell yourself. In the silence, the clock ticks.

Time passes.

It's been fifty-four minutes. It is nine minutes past nine.

>close your yes
You can't see any such thing.

>close your eyes
Time passes.

It's been twenty-two minutes. It is twenty-nine minutes to ten.

>close your eyes
Time passes.

It's been twenty-eight minutes. It is one minute to ten.

>z
Time passes.

It's been thirty-eight minutes. It is twenty-three minutes to eleven.

>z
Time passes.

It's been nine minutes. It is fourteen minutes to eleven.

>z
Time passes.

It's been thirty minutes. It is sixteen minutes past eleven.

>z
Time passes.

It's been fifty-seven minutes. It is thirteen minutes past twelve.

>z
Time passes.

It's been twelve minutes. It is twenty-five past twelve.

>z
Time passes.

It's been fifty-two minutes. It is seventeen minutes past one.

>z
Time passes.

It's been forty-three minutes. It is two o'clock.

>z
Time passes.

It's been nine minutes. It is nine minutes past two.

>z
Time passes.

It's been fifty-one minutes. It is three o'clock.

>z
Time passes.

It's been thirty-nine minutes. It is twenty-one minutes to four.

>z
Time passes.

It's been fifty-two minutes. It is twenty-nine minutes to five.

>z
Time passes.

It's been four minutes. It is twenty-five to five.

>z
Time passes.

It's been twenty minutes. It is five to five.

I beg your pardon?

>z
Time passes.

It's been eleven minutes. It is six minutes past five.

>z
Time passes.

It's been twenty-six minutes. It is twenty-eight minutes to six.

>z
Time passes.

It's been forty-six minutes. It is eighteen minutes past six.

I beg your pardon?

>z
Time passes.

It's been thirty-three minutes. It is nine minutes to seven.

>z
Time passes.

It's been seven minutes. It is two minutes to seven.

>z
Time passes.

It's been fifty-nine minutes. It is three minutes to eight.
It's time...

    *** The End ***

Would you like to RESTART, RESTORE a saved game, QUIT or UNDO the last command?

>z
Please give one of the answers above.

Would you like to RESTART, RESTORE a saved game, QUIT or UNDO the last command?

>z
Please give one of the answers above.

Would you like to RESTART, RESTORE a saved game, QUIT or UNDO the last command?

* * *

>n
Living Room
Mostly bare, just the way you wanted it yesterday. An armchair sits dead center, facing the window.  The bedroom lies to the south.

You can see a living room window and an armchair here.

What do you do this moment?

>e
Hallway
It's pitch black.

It's been fifty-eight minutes. It is twenty-five to nine.

>s
You can't go that way.

It's been seventy-three minutes. It is eleven minutes to ten.

>w
Living Room
Mostly bare, just the way you wanted it yesterday. An armchair sits next to the window. The bedroom lies to the south, and a door lies to the east.

You can see a Living Room window and an armchair (empty) here.

It's been seventy-three minutes. It is three minutes past eleven.

>a
That's not a verb I recognise.

>sit on armchair
Memories of being with your family flood back to you. The smoky smell reminds you of your grandfather, and the way he always smiled at you when you walked by. You lean back and close your eyes to take in a deep breath. Your grandfather passed when you were fifteen. It'll be your turn soon. 
You turn towards your room, wanting to look around.

It's been forty-seven minutes. It is nine minutes to twelve.

>l
Living Room (in the armchair)
Mostly bare, just the way you wanted it yesterday. An armchair sits next to the window. The bedroom lies to the south, and a door lies to the east.

You can see a Living Room window here.

It's been fifty-eight minutes. It is ten to one.

>x window
Outside, Manhattan looks like a sea of fireflies, blinking beneath you. Everything is perfect.

It's been twenty-two minutes. It is thirteen minutes past one.

>l
Living Room (in the armchair)
Mostly bare, just the way you wanted it yesterday. An armchair sits next to the window. The bedroom lies to the south, and a door lies to the east.

You can see a Living Room window here.

It's been thirty-one minutes. It is quarter to two.

>stand up
You get out of the armchair.

Living Room
Mostly bare, just the way you wanted it yesterday. An armchair sits next to the window. The bedroom lies to the south, and a door lies to the east.

You can see a Living Room window and an armchair (empty) here.

It's been fifty-four minutes. It is twenty to three.

>l
You wanted this room yesterday. It reminds you of the emptiness of life, and your impending death.
You just want to stand and wait here.

It's been sixty-nine minutes. It is ten to four.

>z
You're contemplating some more (placeholder).

It's been thirty-seven minutes. It is twenty-eight minutes past four.

* * *

>n
Living Room
Mostly bare, just the way you wanted it yesterday. An armchair sits dead center, facing the window.  The bedroom lies to the south.

You can see a living room window and an armchair here.

What do you do this moment?

>sit in chair
You touch the fabric of the chair, and memories of being with your family flood back to you. You sit down. The smoky smell reminds you of your grandfather, and the way he always smiled at you when you walked by. You lean back and close your eyes to take in a deep breath. Your grandfather passed when you were fifteen. It'll be your turn soon. 
You open your eyes and turn towards your room, wanting to look around.

What do you do this moment?

>l
You wanted this room like this. It reminds you of the emptiness of life, and your impending death. 
You just want to close your eyes and wait here.

What do you do this moment?

>stand
You get out of the armchair.

Living Room
Mostly bare, just the way you wanted it yesterday. An armchair faces the window. The bedroom lies to the south.

You can see a living room window and an armchair (empty) here.

It's been eleven minutes. It is twenty-three minutes to nine.

>l
You wanted this room earlier. It reminds you of the emptiness of life, and your impending death.
You just want to stand and wait here.

It's been forty-three minutes. It is twenty past nine.

* * *

>l
You wanted this room like this. It reminds you of the emptiness of life, and your impending death. 
You just want to close your eyes and wait here.

What do you do this moment?

>z
Breathe, you tell yourself. In the silence, the clock ticks.

Time passes.

What do you do this moment?

>x clock
Your mother taught you how to read an analog clock. 
How 21st century she was. 
Do you remember how to read an analog clock?

>y
She was a good teacher, despite not being a good mother. 
You take a deep breath. Still, you miss her. Her laughter was contagious. Her love, although conditional, was abundant. She wouldn't want to see you like this. 

You miss her.

With your mother in your mind and heart, you're reminded that you have until seven o'clock tomorrow morning, when you, too, will pass and join her.

Well, time sure flies. The clock reads twenty-nine minutes to eight.

What do you do this moment? 3

>l
Living Room (on the armchair)
Mostly bare, but it's beginning to remind you of something. An armchair sits dead center, facing the window. The clock ticks, signaling the passage of time. The bedroom lies to the south.

You can see a clock and a living room window here.

What do you do this moment? 3

>stand up
You get out of the armchair.

Living Room
Mostly bare, just the way you wanted it yesterday. An armchair sits dead center, facing the window. The bedroom lies to the south.

You can see a clock, a living room window and an armchair (empty) here.

>x window
Outside, Manhattan looks like a sea of fireflies, blinking beneath you. Everything is perfect.

>e
You were specifically told to not leave. Are you sure you want to leave?

>e
Please answer yes or no.

>y
Hallway
It's pitch black. The light from the living room behind you isn't doing anything at all.

* * *

>l
Living Room (on the armchair)
Mostly bare, but it's beginning to remind you of something. An armchair sits dead center, facing the window. The clock ticks, signaling the passage of time. The bedroom lies to the south.

You can see a clock and a living room window here.

What do you do this moment? 3

>x clock
Ah, time. For thousands of years, humankind worried about their limited lifespan. But no more. In the last century, the advancements in medicine have allowed wealthy people to streamline the ability to live forever. The layman's explanation? The cells are told to stop aging, and failed organs are replaced with artificial ones.
 
And it was a simple decision, really. 
 
You can remember the exact layout of your desk, years ago, when you made the decision. You turn around and see it just the way it was that day, in the corner of the room. Well, time sure flies. The clock reads ten past eight.
What do you do this moment? 4

>read letter
The letter reads:
"Babe, I love you. 
The words "I'm sorry" was scribbled out, but you can still see it underneath the ink marks. "Thank you. For everything. For all the loving moments."
Continue?

>y
"I'm sorry that I must leave you early. I'm sorry I must leave our child motherless early. But I know he will grow up to be amazing regardless; you certainly did."
Continue?

>y
"Still, Be his friend and his dad. Take him to the baseball games or buy him makeup; whatever he's into."
Continue?

>y
"Love him. Love him again. Love him twice, so he can feel my love, too."
The text becomes a blur as your eyes water and your hands shake.
Breathe. You don't want to keep reading.
Continue?

>y
Still, you wipe away the tears, and read on. "Lastly, mourn for me. Cry, punch, scream, write; whatever you need. 
Then move on."
Continue?

>y
"I will always love you; but please, move on. For yourself, for me, for our child. 
Forever yours. 
Your wife, Kate."
Your legs give out beneath you, and you break down in tears. You just need a moment to be okay.

What do you do this moment? 4

>z
You inhale. Then exhale. 
You wait, patiently. 
Time passes.

Breathe, you tell yourself. You wipe away the tears, regain control of your legs and arms, and pull yourself up. You look at the letter in your hand.

What do you do this moment? 4

>x letter
Your wife's cursive handwriting is difficult to read. Despite having read it a million times, you want to read it again and again.

What do you do this moment? 4

>tap laptop
There's only one button to tap, and it reads "Sign Up Now." You should probably read what's on the laptop first, though. Sign up anyway?

>y
This is what you wanted. To live forever, so you can love forever, and never leave anyone behind. Your child, your grandchild, and your great-grandchild will never have to know loss. 

How wrong you were. Why did I click it? Here you are now, waiting out the last few moments of life. Intentionally waiting for someone to put you down, like a dog. You chuckle in the silence as tears stream down your face. 
This is the end. There's only one thing left for me to do here. It's already twelve minutes past nine.

What do you do this moment? 5

>sleep
You're getting rather tired. The bed must be nearby.

What do you do this moment? 5

>s
(first getting off the armchair)

Bedroom
Your bed is perfectly made for you. Outside the window, you can see the beautiful Manhattan skyline at night like a million stars. The living room lies to the north of your bedroom.

You can see a bed and a bedroom window here.

What do you do this moment? 5

>get in bed
You fall onto the bed, as it engulfs you. 
Ah. It's soft. You could stay here forever.
You close your eyes, and enter a peaceful slumber. You had been loved, you had loved. Death comes naturally, and it just happens to be your turn. You won't wake again.

    *** The End ***

Would you like to RESTART, RESTORE a saved game, QUIT or UNDO the last command?

* * *

>x clock
Your mother taught you how to read an analog clock. 
How 21st century she was. 
Do you remember how to read an analog clock?

>n
The memory of your mother makes your blood boil; she was never there for you. She was a terrible teacher, and an even worse mother. She stopped making dinner for the family when you were 6. She stopped picking you up from school when you were 9. She forgot your 13th birthday, and every birthday after that. 
    Breathe.
Her birth date is July 29th, 2003. 
    Breathe.
She's a Leo. Your grandfather was also a Leo. You miss him. 
    Breathe.
You regain some composure, as your mind wandered back to him.
With your grandfather in your mind and heart, you're reminded that you have until 7:00 am tomorrow, when you, too, will pass and join him.

Well, time sure flies. The clock reads 6:49 pm.

What do you do this moment?

>x clock
Ah, time. For thousands of years, humankind worried about their limited lifespan. But no more. In the last century, the advancements in medicine have allowed wealthy people to streamline the ability to live forever. The layman's explanation? The cells are told to stop aging, and failed organs are replaced with artificial ones.
 
And it was a simple decision, really. 
 
You can remember the exact layout of your desk, years ago, when you made the decision. You turn around and see it just the way it was that day, in the corner of the room. Well, time sure flies. The clock reads 7:09 pm.
What do you do this moment?

>read letter
The letter reads:
"Babe, I love you. 
The words "I'm sorry" was scribbled out, but you can still see it underneath the ink marks. "Thank you. For everything. For all the loving moments."
Continue?

>n
You put the letter down. Her words remind you of her too much.

What do you do this moment?

>shred letter
Are you sure you want to shred the letter?

>y
Feeling betrayed, you put the letter into the shredder. 
"Bbbbbbbbbshhhhhhzzzzzzzzzzzzzzzzzzzz," the shredder hummed.

The letter is now completely destroyed, just like it was before, when you first read it years ago.
How could she? You thought to yourself back then. She didn't even fight it; she just accepted her death, and let the illness take her. You turn to the laptop, and you remembered how you found yourself here.

What do you do this moment?

>tap laptop
There's only one button to tap, and it reads "Sign Up Now." You should probably read what's on the laptop first, though. Sign up anyway?

>y
This is what you wanted. To live forever, so you can love forever, and never leave anyone behind. Your child, your grandchild, and your great-grandchild will never have to know loss. 

How wrong you were. Why did I click it? Here you are now, waiting out the last few moments of life. Intentionally waiting for someone to put you down, like a dog. You chuckle in the silence as tears stream down your face. 
This is the end. There's only one thing left for me to do here. It's already 7:50 pm.

What do you do this moment?

>sleep
You're getting rather tired. The bed must be nearby.

What do you do this moment?

>s
(first getting off the armchair)

Bedroom
Your bed is perfectly made for you. Outside the window, you can see the beautiful Manhattan skyline at night like a million stars. The living room lies to the north of your bedroom.

You can see a bed and a bedroom window here.

What do you do this moment?

>enter bed
You fall onto the bed, as it engulfs you. 
Ah. It's soft. You could stay here forever.
You close your eyes, but only for a brief moment to imagine a large syringe of pentobarbital. You reach for it and plunged it into your heart. You close your eyes while making sure the full dose enters your bloodstream. You won't wake again.

    *** The End ***

Would you like to RESTART, RESTORE a saved game, QUIT or UNDO the last command?

* * *

>l
You wanted this room like this. It reminds you of the emptiness of life, and your impending death. 
You just want to close your eyes and wait here.

What do you do this moment?

>look
Living Room (on the armchair)
Mostly bare, just the way you wanted it yesterday. An armchair sits dead center, facing the window.  The bedroom lies to the south.

You can see a living room window here.

What do you do this moment? 2

>z
Breathe, you tell yourself. In the silence, the clock ticks.

Time passes.

What do you do this moment? 2

>x clock
Your mother taught you how to read an analog clock. 
How 21st century she was. 
Do you remember how to read an analog clock?

>n
The memory of your mother makes your blood boil; she was never there for you. She was a terrible teacher, and an even worse mother. She stopped making dinner for the family when you were 6. She stopped picking you up from school when you were 9. She forgot your 13th birthday, and every birthday after that. 
    Breathe.
Her birth date is July 29th, 2003. 
    Breathe.
She's a Leo. Your grandfather was also a Leo. You miss him. 
    Breathe.
You regain some composure, as your mind wandered back to him.
With your grandfather in your mind and heart, you're reminded that you have until 7:00 am tomorrow, when you, too, will pass and join him.

Well, time sure flies. The clock reads 7:27 pm.

What do you do this moment? 3

>x clock
Ah, time. For thousands of years, humankind worried about their limited lifespan. But no more. In the last century, the advancements in medicine have allowed wealthy people to streamline the ability to live forever. The layman's explanation? The cells are told to stop aging, and failed organs are replaced with artificial ones.
 
And it was a simple decision, really. 
 
You can remember the exact layout of your desk, years ago, when you made the decision. You turn around and see it just the way it was that day, in the corner of the room. Well, time sure flies. The clock reads 8:22 pm.
What do you do this moment? 4

>tap laptop
There's only one button to tap, and it reads "Sign Up Now." You should probably read what's on the laptop first, though. Sign up anyway?

>y
This is what you wanted. To live forever, so you can love forever, and never leave anyone behind. Your child, your grandchild, and your great-grandchild will never have to know loss. 

How wrong you were. Why did I click it? Here you are now, waiting out the last few moments of life. Intentionally waiting for someone to put you down, like a dog. You chuckle in the silence as tears stream down your face. 
This is the end. There's only one thing left for me to do here. It's already 8:23 pm.

What do you do this moment? 5

>kill myself
You're getting rather tired. The bed must be nearby.

What do you do this moment? 5

>s
(first getting off the armchair)

Bedroom
Your bed is perfectly made for you. Outside the window, you can see the beautiful Manhattan skyline at night like a million stars. The living room lies to the north of your bedroom.

You can see a bed and a bedroom window here.

What do you do this moment? 5

>x bed
Tidy and perfect; you probably could sink into it. A good place to end, you think.

What do you do this moment? 5

>get in bed
You fall onto the bed, as it engulfs you. 
Ah. It's soft. You could stay here forever.
You close your eyes, realizing you didn't amount to much in your life. Just a victim of circumstance, you thought to yourself. You won't wake again.

    *** The End ***

Would you like to RESTART, RESTORE a saved game, QUIT or UNDO the last command?

* * *

>sit in chair
You touch the fabric of the chair, and memories of being with your family flood back to you. You sit down. The smoky smell reminds you of your grandfather, and the way he always smiled at you when you walked by. You lean back and close your eyes to take in a deep breath. Your grandfather passed when you were fifteen. It'll be your turn soon. 
You open your eyes and turn towards your room, wanting to look around.

What do you do this moment?

>z
Breathe, you tell yourself. In the silence, the clock ticks.

Time passes.

What do you do this moment?

>breathe
You wait, patiently. 
Time passes.

What do you do this moment?

>x clock
Your mother taught you how to read an analog clock; how 21st century she was. Do you remember how to read an analog clock?

>n
The memory of your mother makes your blood boil; she was never there for you. She was a terrible teacher, and an even worse mother. She stopped making dinner for the family when you were 6. She stopped picking you up from school when you were 9. She forgot your 13th birthday, and every birthday after that. 
    Breathe.
Her birth date is July 29th, 2003. 
    Breathe.
She's a Leo. Your grandfather was also a Leo. You miss him. 
    Breathe.
You regain some composure, as your mind wandered back to him.
With your grandfather in your mind and heart, you're reminded that you have until 7:00 am tomorrow, when you, too, will pass and join him.

Well, time sure flies. The clock reads 6:58 pm.

What do you do this moment?

>wait
You wait, patiently. 
Time passes.

What do you do this moment?

>x clock
Ah, time. For thousands of years, humankind worried about their limited lifespan. But no more. In the last century, the advancements in medicine have allowed wealthy people to streamline the ability to live forever. The layman's explanation? The cells are told to stop aging, and failed organs are replaced with artificial ones.
 
And it was a simple decision, really. 
You can remember the exact layout of your desk, years ago, when you made the decision. You turn around and see it just the way it was that day, in the corner of the room.
Well, time sure flies. The clock reads 7:28 pm.
What do you do this moment?

>shred letter
Are you sure you want to shred the letter?

* * *

>y
Feeling betrayed, you put the letter into the shredder. 
"Bbbbbbbbbshhhhhhzzzzzzzzzzzzzzzzzzzz," the shredder hummed.

The letter is now completely destroyed, just like it was before, when you first read it years ago.
How could she? You thought to yourself back then. She didn't even fight it; she just accepted her death, and let the illness take her. You turn to the laptop, and you remembered how you found yourself here.

What do you do this moment?

>tap laptop
There's only one button to tap, and it reads "Sign Up Now." You should probably read what's on the laptop first, though.
Tap it?

* * *

>y
This is what you wanted. To live forever, so you can love forever, and never leave anyone behind. Your child, your grandchild, and your great-grandchild will never have to know loss. 

How wrong you were. Why did I click it? Here you are now, waiting out the last few moments of life. Intentionally waiting for someone to put you down, like a dog. You chuckle in the silence.
(EN: This is what I've made so far - there is a specific action left, which can end the game. You can also wait around until the game ends, up to you. - Hung)
What do you do this moment?

>kill myself
You're getting rather tired. The bed must be nearby.

What do you do this moment?

* * *

>s
(first getting off the armchair)

Bedroom
Your bed is perfectly made. Outside the window, you can see the beautiful Manhattan skyline at night like a million stars. The living room lies to the north of your bedroom.

You can see a bed and a bedroom window here.

What do you do this moment?

>x bed
Tidy and perfect; you probably could sink into it. A good place to end, you think.

What do you do this moment?

>enter bed
You fall onto the bed, as it engulfs you. 
Ah. It's soft. You could stay here forever.
You close your eyes, but only for a brief moment to imagine a large syringe of pentobarbital. You reach for it and plunged it into your heart. You close your eyes while making sure the full dose enters your bloodstream.
You won't wake again.

    *** The End ***

Would you like to RESTART, RESTORE a saved game, QUIT or UNDO the last command?

* * *

>x clock
Your mother taught you how to read an analog clock. 
How 21st century she was. 
Do you remember how to read an analog clock?

>n
The memory of your mother makes your blood boil; she was never there for you. She was a terrible teacher, and an even worse mother. She stopped making dinner for the family when you were 6. She stopped picking you up from school when you were 9. She forgot your 13th birthday, and every birthday after that. 
    Breathe.
Her birth date is July 29th, 2003. 
    Breathe.
She's a Leo. Your grandfather was also a Leo. You miss him. 
    Breathe.
You regain some composure, as your mind wandered back to him.
With your grandfather in your mind and heart, you're reminded that you have until 7:00 am tomorrow, when you, too, will pass and join him.

Well, time sure flies. The clock reads 7:03 pm.

What do you do this moment?

>x clock
Ah, time. For thousands of years, humankind worried about their limited lifespan. But no more. In the last century, the advancements in medicine have allowed wealthy people to streamline the ability to live forever. The layman's explanation? The cells are told to stop aging, and failed organs are replaced with artificial ones.
 
And it was a simple decision, really. 
 
You can remember the exact layout of your desk, years ago, when you made the decision. You turn around and see it just the way it was that day, in the corner of the room. Well, time sure flies. The clock reads 8:01 pm.
What do you do this moment?

>x desk
A clear, wooden desk, popular back in the 2030's.  You picked it out when you first got your own place. It brings back so many memories.

On the desk are a shredder (empty), a laptop and a letter.

What do you do this moment? 25

>read letter
The letter reads:
"Babe, I love you. 
The words "I'm sorry" was scribbled out, but you can still see it underneath the ink marks. "Thank you. For everything. For all the loving moments." Continue?

* * *

>y
Still, you wipe away the tears, and read on. "Lastly, mourn for me. Cry, punch, scream, write; whatever you need. 
Then move on." Continue?

>y
"I will always love you; but please, move on. For yourself, for me, for our child. 
Forever yours. 
Your wife, 

Kate In-young Dessalegn."
Your legs give out beneath you, and you break down in tears. You just need a moment to be okay.

What do you do this moment? 25

>z
You wait, patiently. 
Time passes.

Breathe, you tell yourself. You wipe away the tears, regain control of your legs and arms, and pull yourself up. You look at the letter in your hand.

What do you do this moment? 25

>stand up
You get off the armchair.

Living Room
Mostly bare, but it's beginning to remind you of something. An armchair sits dead center, facing the window. The clock ticks, signaling the passage of time. The bedroom lies to the south.

You can see a desk (on which are a shredder (empty), a laptop and a letter), a clock, a living room window and an armchair here.

What do you do this moment? 25

>x laptop
An old laptop. It's a perfect replica of your university's Surface Air, and you're reminded how old you are when you realized it doesn't support air touch; instead, you can only tap it.

What do you do this moment? 25

>read laptop
August 10th, 2057 
Dear friend, welcome to the future. My name is Steven Musk, founder of Elon Tech. If you are here, you know we have mastered death.  
I'm proud to announce that today, Elon Tech will open up this technology to the public, allowing anyone to be able to extend their lives indefinitely.  Join the human evolution with me. Subscribe below.

Sign Up Now
What do you do this moment? 25

>tap laptop
There's only one button to tap, and it reads "Sign Up Now." Tap it?

>y
This is what you wanted. To live forever, so you can love forever, and never leave anyone behind. Your child, your grandchild, and your great-grandchild will never have to know loss. 

How wrong you were. Why did I click it? Here you are now, waiting out the last few moments of life. Intentionally waiting for someone to put you down, like a dog. You chuckle in the silence.
(EN: This is what I've made so far - there is a specific action left, which can end the game. You can also wait around until the game ends, up to you. - Hung)
What do you do this moment? 66

>restart
Are you sure you want to restart?

>y
Is this the real life?
Is this just fantasy?
Caught in a landslide
No escape from reality...
cw: euthanasia, depression
The Clock Ticks for You
An Interactive Fiction by Hung Nguyen
Release 1 / Serial number 181101 / Inform 7 build 6M62 (I6/v6.33 lib 6/12N) SD

You mentally turn off Queen from playing in your head. 
It's old and overplayed, you thought to yourself and get out of bed.

Bedroom
Your bed is perfectly made. Outside the window, you can see the sun setting on the Manhattan skyline, bleeding orange onto you. The living room lies to the north of your bedroom.

You can see a bed and a bedroom window here.

What do you do this moment? 50

>n
Living Room
Mostly bare, just the way you wanted it yesterday. An armchair sits dead center, facing the window.  The bedroom lies to the south.

You can see a living room window and an armchair here.

What do you do this moment? 50

>sit
What do you want to sit on?

What do you do this moment? 50

>in chair
I only understood you as far as wanting to sit on inside.

What do you do this moment? 50

>sit on chair
You touch the fabric of the chair, and memories of being with your family flood back to you. You sit down. The smoky smell reminds you of your grandfather, and the way he always smiled at you when you walked by. You lean back and close your eyes to take in a deep breath. Your grandfather passed when you were fifteen. It'll be your turn soon. 
You open your eyes and turn towards your room, wanting to look around.

You wanted this room earlier today. It reminds you of the emptiness of life, and your impending death. 
You just want to close your eyes and wait here.

What do you do this moment? 50

>z
Breathe, you tell yourself. In the silence, the clock ticks.

Time passes.

What do you do this moment? 50

>x clock
Your mother taught you how to read an analog clock; how 21st century she was. Do you remember how to read an analog clock?

>y
She was a good teacher, despite not being a good mother. 
You take a deep breath. Still, you miss her. Her laughter was contagious. Her love, although conditional, was abundant. She wouldn't want to see you like this. 

You miss her.

With your mother in your mind and heart, you're reminded that you have until seven o'clock tomorrow morning, when you, too, will pass and join her.

Well, time sure flies. The clock reads twenty-one minutes to seven.

What do you do this moment? 66

>l
Living Room (on the armchair)
Mostly bare, but it's beginning to remind you of something. An armchair sits dead center, facing the window. The clock ticks, signaling the passage of time. The bedroom lies to the south.

You can see a clock and a living room window here.

What do you do this moment? 66

>x clock
Ah, time. For thousands of years, humankind worried about their limited lifespan. But no more. In the last century, the advancements in medicine have allowed wealthy people to streamline the ability to live forever. The layman's explanation? The cells are told to stop aging, and failed organs are replaced with artificial ones.
 
And it was a simple decision, really. 
You can remember the exact layout of your desk, years ago, when you made the decision. You turn around and see it just the way it was that day, in the corner of the room.
Well, time sure flies. The clock reads eight o'clock.
What do you do this moment? 66

>read letter
The letter reads:
"Babe, I love you. 
The words "I'm sorry" was scribbled out, but you can still see it underneath the ink marks. "Thank you. For everything. For all the loving moments." Continue?

* * *

>y
Still, you wipe away the tears, and read on. "Lastly, mourn for me. Cry, punch, scream, write; whatever you need. 
Then move on." Continue?

>y
"I will always love you; but please, move on. For yourself, for me, for our child. 
Forever yours. 
Your wife, 

Kate In-young Dessalegn."
Your legs give out beneath you, and you break down in tears. You just need a moment to be okay.

What do you do this moment? 66

>tap laptop
There's only one button to tap, and it reads "Sign Up Now." You should probably read what's on the laptop first, though.
Tap it?

>y
This is what you wanted. To live forever, so you can love forever, and never leave anyone behind. Your child, your grandchild, and your great-grandchild will never have to know loss. 

How wrong you were. Why did I click it? Here you are now, waiting out the last few moments of life. Intentionally waiting for someone to put you down, like a dog. You chuckle in the silence.
(EN: This is what I've made so far - there is a specific action left, which can end the game. You can also wait around until the game ends, up to you. - Hung)
Breathe, you tell yourself. You wipe away the tears, regain control of your legs and arms, and pull yourself up. You look at the letter in your hand.

What do you do this moment? 80

>sleep
You're getting rather tired. The bed must be nearby.

What do you do this moment? 80

>x bed
You can't see any such thing.

What do you do this moment? 80

>s
(first getting off the armchair)

Bedroom
Your bed is perfectly made. Outside the window, you can see the beautiful Manhattan skyline at night like a million stars. The living room lies to the north of your bedroom.

You can see a bed and a bedroom window here.

What do you do this moment? 80

>x bed
Tidy and perfect; you probably could sink into it. A good place to end, you think.

What do you do this moment? 80

>get in bed
You fall onto the bed, as it engulfs you. 
Ah. It's soft. You could stay here forever.
You close your eyes, and enter a peaceful slumber. You had been loved, you had loved. Death comes naturally, and it just happens to be your turn. You won't wake again.

    *** The End ***

Would you like to RESTART, RESTORE a saved game, QUIT or UNDO the last command?

* * *

>x clock
Well, time sure flies. The clock reads 8:38 pm.
What do you do this moment?

I beg your pardon?

What do you do this moment?

I beg your pardon?

What do you do this moment?

I beg your pardon?
If you are new to interactive fiction, you may like to try typing "help."

What do you do this moment?

I beg your pardon?
If you are new to interactive fiction, you may like to try typing "help."

What do you do this moment?

>x clock
Well, time sure flies. The clock reads 9:15 pm.
What do you do this moment?

>x clock
Life is composed of moments, unmeasurable by any clock.
Well, time sure flies. The clock reads 10:09 pm.
What do you do this moment?

>x clock
Life is composed of moments, unmeasurable by any clock.
The more conscious we are of our time left, the less time we actually end up having. Well, time sure flies. The clock reads 10:32 pm.
What do you do this moment?

>x clock
Life is composed of moments, unmeasurable by any clock.
The more conscious we are of our time left, the less time we actually end up having. Well, time sure flies. The clock reads 11:02 pm.
What do you do this moment?

>x clock
Life is composed of moments, unmeasurable by any clock.
The more conscious we are of our time left, the less time we actually end up having. Well, time sure flies. The clock reads 11:38 pm.
What do you do this moment?

>x clock
Life is composed of moments, unmeasurable by any clock.
The more conscious we are of our time left, the less time we actually end up having. Well, time sure flies. The clock reads 11:53 pm.
What do you do this moment?

>x clock
Life is composed of moments, unmeasurable by any clock.
The more conscious we are of our time left, the less time we actually end up having. Well, time sure flies. The clock reads 12:21 am.
What do you do this moment?

>x clock
Life is composed of moments, unmeasurable by any clock.
The more conscious we are of our time left, the less time we actually end up having. Well, time sure flies. The clock reads 1:13 am.
What do you do this moment?

>x clock
Life is composed of moments, unmeasurable by any clock.
The more conscious we are of our time left, the less time we actually end up having. Well, time sure flies. The clock reads 1:30 am.
What do you do this moment?

>x clock
Life is composed of moments, unmeasurable by any clock.
The more conscious we are of our time left, the less time we actually end up having. Well, time sure flies. The clock reads 1:53 am.
What do you do this moment?

>x clock
Life is composed of moments, unmeasurable by any clock.
The more conscious we are of our time left, the less time we actually end up having. Well, time sure flies. The clock reads 2:48 am.
What do you do this moment?

>x clock
Life is composed of moments, unmeasurable by any clock.
The more conscious we are of our time left, the less time we actually end up having. Well, time sure flies. The clock reads 3:28 am.
What do you do this moment?

>x clock
Life is composed of moments, unmeasurable by any clock.
The more conscious we are of our time left, the less time we actually end up having. Well, time sure flies. The clock reads 3:46 am.
What do you do this moment?

>x clock
Life is composed of moments, unmeasurable by any clock.
The more conscious we are of our time left, the less time we actually end up having. Well, time sure flies. The clock reads 4:37 am.
What do you do this moment?

>x clock
Life is composed of moments, unmeasurable by any clock.
The more conscious we are of our time left, the less time we actually end up having. Well, time sure flies. The clock reads 5:02 am.
What do you do this moment?

>x clock
Life is composed of moments, unmeasurable by any clock.
The more conscious we are of our time left, the less time we actually end up having. Well, time sure flies. The clock reads 6:01 am.
What do you do this moment?

>x clock
Life is composed of moments, unmeasurable by any clock.
The more conscious we are of our time left, the less time we actually end up having. Well, time sure flies. The clock reads 6:33 am.
What do you do this moment?

>x clock
Life is composed of moments, unmeasurable by any clock.
The more conscious we are of our time left, the less time we actually end up having. Well, time sure flies. The clock reads 6:57 am.
What do you do this moment?

>x clock
Life is composed of moments, unmeasurable by any clock.
The more conscious we are of our time left, the less time we actually end up having. Well, time sure flies. The clock reads 7:00 am.
Your strength suddenly fades. You collapse. It must be 7:00 am.  You miss them so much. Everyone you loved, dying one by one. Everyone dies. It's your turn. Why was I born? You won't wake again.

    *** The End ***

Would you like to RESTART, RESTORE a saved game, QUIT or UNDO the last command?

* * *

>sit in chair
You touch the fabric of the chair, and memories of being with your family flood back to you. You sit down. The smoky smell reminds you of your grandfather, and the way he always smiled at you when you walked by. You lean back and close your eyes to take in a deep breath. Your grandfather passed when you were fifteen. It'll be your turn soon. 
You open your eyes and turn towards your room, wanting to look around.

What do you do this moment?

I beg your pardon?

What do you do this moment? 1

>l
You wanted this room like this. It reminds you of the emptiness of life, and your impending death. 
You just want to close your eyes and wait here.

What do you do this moment? 2

>l
Living Room (on the armchair)
Mostly bare, just the way you wanted it yesterday. An armchair sits dead center, facing the window.  The bedroom lies to the south.

You can see a living room window here.

What do you do this moment? 2

>z
Breathe, you tell yourself. In the silence, the clock ticks.

Time passes.

What do you do this moment? 2

>z
Breathe, you tell yourself. In the silence, the clock ticks.

Time passes.

What do you do this moment? 2

>look
Living Room (on the armchair)
Mostly bare, just the way you wanted it yesterday. An armchair sits dead center, facing the window.  The bedroom lies to the south.

You can see a clock and a living room window here.

What do you do this moment? 2

>x clock
Your mother taught you how to read an analog clock. 
How 21st century she was. 
Do you remember how to read an analog clock?

>n
The memory of your mother makes your blood boil; she was never there for you. She was a terrible teacher, and an even worse mother. She stopped making dinner for the family when you were 6. She stopped picking you up from school when you were 9. She forgot your 13th birthday, and every birthday after that. 
    Breathe.
Her birth date is July 29th, 2003. 
    Breathe.
She's a Leo. Your grandfather was also a Leo. You miss him. 
    Breathe.
You regain some composure, as your mind wandered back to him.
With your grandfather in your mind and heart, you're reminded that you have until 7:00 am tomorrow, when you, too, will pass and join him.

Well, time sure flies. The clock reads 7:34 pm.

What do you do this moment? 3

>x clock
Ah, time. For thousands of years, humankind worried about their limited lifespan. But no more. In the last century, the advancements in medicine have allowed wealthy people to streamline the ability to live forever. The layman's explanation? The cells are told to stop aging, and failed organs are replaced with artificial ones.
 
And it was a simple decision, really. 
 
You can remember the exact layout of your desk, years ago, when you made the decision. You turn around and see it just the way it was that day, in the corner of the room. Well, time sure flies. The clock reads 8:17 pm.
What do you do this moment? 4

>l desk
A clear, wooden desk, popular back in the 2030's.  You picked it out when you first got your own place. It brings back so many memories.

On the desk are a shredder (empty), a laptop and a letter.

What do you do this moment? 4

>x letter
Your wife's cursive handwriting is difficult to read. Despite having read it a million times, you want to read it again.

What do you do this moment? 4

>tap laptop
There's only one button to tap, and it reads "Sign Up Now." You should probably read what's on the laptop first, though. Sign up anyway?

>y
This is what you wanted. To live forever, so you can love forever, and never leave anyone behind. Your child, your grandchild, and your great-grandchild will never have to know loss. 

How wrong you were. Why did I click it? Here you are now, waiting out the last few moments of life. Intentionally waiting for someone to put you down, like a dog. You chuckle in the silence as tears stream down your face. 
This is the end. There's only one thing left for me to do here. It's already 8:37 pm.

What do you do this moment? 5

* * *

>n
Living Room
Mostly bare, just the way you wanted it yesterday. An armchair sits dead center, facing the window.  The bedroom lies to the south.

You can see a living room window and an armchair here.

What do you do this moment?

>s
Bedroom
Your bed is perfectly made. Outside the window, you can see the beautiful Manhattan skyline at night like a million stars. The living room lies to the north of your bedroom.

You can see a bed (empty) and a bedroom window here.

It's been seventeen minutes. It is eleven minutes to eight.

>l
Bedroom
Your bed is perfectly made. Outside the window, you can see the beautiful Manhattan skyline at night like a million stars. The living room lies to the north of your bedroom.

You can see a bed (empty) and a bedroom window here.

It's been seventeen minutes. It is six minutes past eight.

>sit
What do you want to sit on?

>chair
You can't see any such thing.

>chair
That's not a verb I recognise.

>sit on chair
You can't see any such thing.

>sit on armchair
You can't see any such thing.

>n
Living Room
Mostly bare, just the way you wanted it yesterday. An armchair sits dead center, facing the window. The bedroom lies to the south.

You can see a living room window and an armchair (empty) here.

It's been thirty-five minutes. It is nineteen minutes to nine.

>sit on chair
You touch the fabric of the chair, and memories of being with your family flood back to you. You sit down. The smoky smell reminds you of your grandfather, and the way he always smiled at you when you walked by. You lean back and close your eyes to take in a deep breath. Your grandfather passed when you were fifteen. It'll be your turn soon. 
You open your eyes and turn towards your room, wanting to look around.

It's been fifty-seven minutes. It is twenty-two minutes to ten.

>ll
That's not a verb I recognise.

>l
You wanted this room earlier today. It reminds you of the emptiness of life, and your impending death. 
You just want to close your eyes and wait here.

It's been forty-two minutes. It is twenty past ten.

>z
You're contemplating some more (placeholder).

Time passes.

It's been forty-two minutes. It is two minutes past eleven.

>l
Living Room (in the armchair)
Mostly bare, just the way you wanted it yesterday. An armchair sits dead center, facing the window. The bedroom lies to the south.

You can see a living room window here.

It's been fifty-four minutes. It is four minutes to twelve.

>l
Living Room (in the armchair)
Mostly bare, just the way you wanted it yesterday. An armchair sits dead center, facing the window. The bedroom lies to the south.

You can see a living room window here.

It's been forty-nine minutes. It is quarter to one.

>sink into bedroom
You can't see any such thing.

>close eys
You can't see any such thing.

>close eyes
Time passes.

It's been twenty-four minutes. It is nine minutes past one.

* * *

>n
Living Room
Mostly bare, just the way you wanted it yesterday. An armchair sits dead center, facing the window.  The bedroom lies to the south.

You can see a living room window and an armchair here.

What do you do this moment?

>sit
What do you want to sit on?

>chair
You touch the fabric of the chair, and memories of being with your family flood back to you. You sit down. The smoky smell reminds you of your grandfather, and the way he always smiled at you when you walked by. You lean back and close your eyes to take in a deep breath. Your grandfather passed when you were fifteen. It'll be your turn soon. 
You open your eyes and turn towards your room, wanting to look around.

It's been nineteen minutes. It is eleven minutes past seven.

>l
You wanted this room earlier today. It reminds you of the emptiness of life, and your impending death. 
You just want to close your eyes and wait here.

It's been nineteen minutes. It is half past seven.

>z
Breathe, you tell yourself. In the silence, the clock ticks.

Time passes.

It's been two minutes. It is twenty-eight minutes to eight.

>l
Living Room (in the armchair)
Mostly bare, just the way you wanted it yesterday. An armchair sits dead center, facing the window. The bedroom lies to the south.

You can see a clock and a living room window here.

It's been six minutes. It is twenty-two minutes to eight.

>x window
Well, time sure flies.

Outside, Manhattan looks like a sea of fireflies, blinking beneath you. Everything is perfect.

>x clock
Well, time sure flies.

The time is five to eight.

>z
Time passes.

It's been twelve minutes. It is seven minutes past eight.

* * *

>sit
What do you want to sit on?

>chair
You touch the fabric of the chair, and memories of being with your family flood back to you. You sit down. The smoky smell reminds you of your grandfather, and the way he always smiled at you when you walked by. You lean back and close your eyes to take in a deep breath. Your grandfather passed when you were fifteen. It'll be your turn soon. 
You open your eyes and turn towards your room, wanting to look around.

>l
You wanted this room earlier today. It reminds you of the emptiness of life, and your impending death. 
You just want to close your eyes and wait here.

* * *

>x clock
Your mother taught you how to read an analog clock; how 21st century she was. Do you remember how to read an analog clock?

>n
The memory of your mother makes your blood boil; she was never there for you. She was a terrible teacher, and an even worse mother. She stopped making dinner for the family when you were 6. She stopped picking you up from school when you were 9. She forgot your 13th birthday, and every birthday after that. 
    Breathe.
Her birth date is July 29th, 2003. 
    Breathe.
She's a Leo. Your grandfather was also a Leo. You miss him. 
    Breathe.
You regain some composure, as your mind wandered back to him.
With your grandfather in your mind and heart, you're reminded that you have until 7:00 am, when you, too, will pass and join him.

Well, time sure flies. The clock reads 7:15 pm.

>x clock
Well, time sure flies. The clock reads 7:34 pm.

>x clock
Well, time sure flies. The clock reads 8:16 pm.

>x clock
Well, time sure flies. The clock reads 8:28 pm.

>x clock
Well, time sure flies. The clock reads 9:24 pm.

>x clock
Well, time sure flies. The clock reads 9:38 pm.

>x clock
Well, time sure flies. The clock reads 9:44 pm.

* * *

>n
Living Room
Mostly bare, just the way you wanted it yesterday. An armchair sits dead center, facing the window.  The bedroom lies to the south.

You can see a living room window and an armchair here.

What do you do this moment?

>touch chair
You touch the fabric of the chair, and memories of being with your family flood back to you. You sit down. The smoky smell reminds you of your grandfather, and the way he always smiled at you when you walked by. You lean back and close your eyes to take in a deep breath. Your grandfather passed when you were fifteen. It'll be your turn soon. 
You open your eyes and turn towards your room, wanting to look around.

You wanted this room earlier today. It reminds you of the emptiness of life, and your impending death. 
You just want to close your eyes and wait here.

What do you do this moment?

>sit in chair
But you're already on the armchair.

* * *

>touch chair
The fabric feels worn out.

What do you do this moment?

>smell chair
You put your nose to the fabric and inhale the old tobacco smoke. 
It's home.

What do you do this moment?

* * *

>z
You wait, patiently. 
Time passes.

What do you do this moment? 50

>z
You wait, patiently. 
Time passes.

What do you do this moment? 50

I beg your pardon?

I beg your pardon?

>zz
That's not a verb I recognise.

>z
It's been twenty-four minutes. It is twenty-nine minutes past seven.

>l
Bedroom
Your bed is perfectly made. Outside the window, you can see the sun setting on the Manhattan skyline, bleeding orange onto you. The living room lies to the north of your bedroom.

You can see a bed and a bedroom window here.

It's been twenty-five minutes. It is five to eight.

* * *

I beg your pardon?

>l
Bedroom
Your bed is perfectly made. Outside the window, you can see the beautiful Manhattan skyline at night like a million stars. The living room lies to the north of your bedroom.

You can see a bed (empty) and a bedroom window here.

It's been forty-nine minutes. It is thirteen minutes past nine.

>l
Bedroom
Your bed is perfectly made. Outside the window, you can see the sun setting on the Manhattan skyline, bleeding orange onto you. The living room lies to the north of your bedroom.

You can see a bed and a bedroom window here.

It's been ten minutes. It is twelve minutes past eight. Y

>x window
Outside, Manhattan glitters beneath you. Everything is perfect.

It's been five minutes. It is eighteen minutes past eight. Y

* * *

>l
Bedroom
Your bed is perfectly made. Outside the window, you can see the beautiful Manhattan skyline at night like a million stars. The living room lies to the north of your bedroom.

You can see a bed (empty) and a bedroom window here.

It's been forty-nine minutes. It is thirteen minutes past nine.

>x window
Outside, Manhattan looks like a sea of fireflies, blinking  beneath you. Everything is perfect.

It's been fifty-two minutes. It is six minutes past ten.

* * *

>z
You wait, patiently. 
Time passes.

What do you do this moment? 50

>z
It's been thirty minutes. It is twenty-five past eight.

>z
It's been five minutes. It is twenty-nine minutes to nine.

>z
It's been seventeen minutes. It is eleven minutes to nine.

>z
It's been six minutes. It is four minutes to nine.

>z
It's been five minutes. It is two minutes past nine.

>z
It's been nineteen minutes. It is twenty-two minutes past nine.

>z
It's been seven minutes. It is half past nine.

>z
It's been thirteen minutes. It is sixteen minutes to ten.

>z
It's been nineteen minutes. It is four minutes past ten.

>z
It's been thirteen minutes. It is eighteen minutes past ten.

>z
It's been twenty-one minutes. It is twenty to eleven.

* * *

>z
You wait, patiently. 
Time passes.

What do you do this moment? 50

>l
Bedroom
Your bed is perfectly made. Outside the window, you can see the sun setting on the Manhattan skyline, bleeding orange onto you. The living room lies to the north of your bedroom.

You can see a bed and a bedroom window here.

What do you do this moment? 50

>n
Living Room
Mostly bare, just the way you wanted it yesterday. An armchair sits dead center, facing the window.  The bedroom lies to the south.

You can see a living room window and an armchair here.

What do you do this moment? 50

* * *

>sit
What do you want to sit on?

What do you do this moment? 50

>chair
You touch the fabric of the chair, and memories of being with your family flood back to you. You sit down. The smoky smell reminds you of your grandfather, and the way he always smiled at you when you walked by. You lean back and close your eyes to take in a deep breath. Your grandfather passed when you were fifteen. It'll be your turn soon. 
You open your eyes and turn towards your room, wanting to look around.

You wanted this room like this. It reminds you of the emptiness of life, and your impending death. 
You just want to close your eyes and wait here.

What do you do this moment? 50

>z
Breathe, you tell yourself. In the silence, the clock ticks.

Time passes.

What do you do this moment? 50

* * *

>x clock
Your mother taught you how to read an analog clock; how 21st century she was. Do you remember how to read an analog clock?

>y
She was a good teacher, despite not being a good mother. 
You take a deep breath. Still, you miss her. Her laughter was contagious. Her love, although conditional, was abundant. She wouldn't want to see you like this. 

You miss her.

With your mother in your mind and heart, you're reminded that you have until seven o'clock tomorrow morning, when you, too, will pass and join her.

Well, time sure flies. The clock reads seven minutes to seven. 

What do you do this moment? 66

>x clock
Ah, time. For thousands of years, humankind worried about their limited lifespan. But no more. In the last century, the advancements in medicine have allowed wealthy people to streamline the ability to live forever. The layman's explanation? The cells are told to stop aging, and failed organs are replaced with artificial ones.
 
And it was a simple decision, really. 
You can remember the exact layout of your desk, years ago, when you made the decision. You turn around and see it just the way it was that day, in the corner of the room.
Well, time sure flies. The clock reads quarter to eight. 
What do you do this moment? 66

>x clock
Well, time sure flies. The clock reads twenty-nine minutes to nine. 
What do you do this moment? 66

>x clock
Well, time sure flies. The clock reads eighteen minutes past nine. 
What do you do this moment? 66

>x clock
Life is composed of moments, unmeasurable by any clock.
Well, time sure flies. The clock reads twenty-nine minutes past nine. 
What do you do this moment? 66

>x clock
Life is composed of moments, unmeasurable by any clock.
The more conscious we are of our time left, the less time we actually end up having. Well, time sure flies. The clock reads two minutes past ten. 
What do you do this moment? 66

>x clock
Life is composed of moments, unmeasurable by any clock.
The more conscious we are of our time left, the less time we actually end up having. Well, time sure flies. The clock reads one minute past eleven. 
What do you do this moment? 66

>x clock
Life is composed of moments, unmeasurable by any clock.
The more conscious we are of our time left, the less time we actually end up having. Well, time sure flies. The clock reads eighteen minutes to twelve. 
What do you do this moment? 66

>x clock
Life is composed of moments, unmeasurable by any clock.
The more conscious we are of our time left, the less time we actually end up having. Well, time sure flies. The clock reads twenty-five to one. 
What do you do this moment? 66

>x clock
Life is composed of moments, unmeasurable by any clock.
The more conscious we are of our time left, the less time we actually end up having. Well, time sure flies. The clock reads eighteen minutes past one. 
What do you do this moment? 66

>x clock
Life is composed of moments, unmeasurable by any clock.
The more conscious we are of our time left, the less time we actually end up having. Well, time sure flies. The clock reads eleven minutes to two. 
What do you do this moment? 66

>x clock
Life is composed of moments, unmeasurable by any clock.
The more conscious we are of our time left, the less time we actually end up having. Well, time sure flies. The clock reads twenty-two minutes past two. 
What do you do this moment? 66

>x clock
Life is composed of moments, unmeasurable by any clock.
The more conscious we are of our time left, the less time we actually end up having. Well, time sure flies. The clock reads thirteen minutes to three. 
What do you do this moment? 66

>x clock
Life is composed of moments, unmeasurable by any clock.
The more conscious we are of our time left, the less time we actually end up having. Well, time sure flies. The clock reads twenty-eight minutes past three. 
What do you do this moment? 66

>x clock
Life is composed of moments, unmeasurable by any clock.
The more conscious we are of our time left, the less time we actually end up having. Well, time sure flies. The clock reads quarter past four. 
What do you do this moment? 66

>x clock
Life is composed of moments, unmeasurable by any clock.
The more conscious we are of our time left, the less time we actually end up having. Well, time sure flies. The clock reads seven minutes to five. 
What do you do this moment? 66

>x clock
Life is composed of moments, unmeasurable by any clock.
The more conscious we are of our time left, the less time we actually end up having. Well, time sure flies. The clock reads twenty-four minutes past five. 
What do you do this moment? 66

>x clock
Life is composed of moments, unmeasurable by any clock.
The more conscious we are of our time left, the less time we actually end up having. Well, time sure flies. The clock reads twenty past six. 
What do you do this moment? 66

>x clock
Life is composed of moments, unmeasurable by any clock.
The more conscious we are of our time left, the less time we actually end up having. Well, time sure flies. The clock reads nine minutes to seven. 
What do you do this moment? 66

>x clock
Life is composed of moments, unmeasurable by any clock.
The more conscious we are of our time left, the less time we actually end up having. Well, time sure flies. The clock reads thirteen minutes past seven. 
Your strength suddenly fades. Your time is up.  Just a victim of circumstance, you lie to yourself, one last time. You won't wake again.

    *** The End ***

Would you like to RESTART, RESTORE a saved game, QUIT or UNDO the last command?

>x clock
Please give one of the answers above.

Would you like to RESTART, RESTORE a saved game, QUIT or UNDO the last command?

>x clock
Please give one of the answers above.

Would you like to RESTART, RESTORE a saved game, QUIT or UNDO the last command?

* * *

I beg your pardon?

>z
It's been fifty-five minutes. It is seventeen minutes past eight.

>l
Bedroom
Your bed is perfectly made. Outside the window, you can see the beautiful Manhattan skyline at night like a million stars. The living room lies to the north of your bedroom.

You can see a bed (empty) and a bedroom window here.

It's been fifty-three minutes. It is eleven minutes past nine.

>x window
Outside, Manhattan looks like a sea of fireflies, blinking beneath you. Everything is perfect.

It's been twenty-eight minutes. It is twenty to ten.

* * *

>w
You can't go that way.

It's been twenty-six minutes. It is three minutes past seven.

>x window
Outside, Manhattan glitters beneath you. Everything is perfect.

It's been eighteen minutes. It is twenty-two minutes past seven.

>x window
Outside, Manhattan glitters beneath you. Everything is perfect.

It's been six minutes. It is twenty-nine minutes past seven.

>x window
Outside, Manhattan glitters beneath you. Everything is perfect.

It's been eleven minutes. It is nineteen minutes to eight.

>x window
Outside, Manhattan glitters beneath you. Everything is perfect.

It's been twenty-two minutes. It is four minutes past eight.

>l
Bedroom
Your bed is perfectly made. Outside the window, you can see the beautiful Manhattan skyline at night like a million stars. The living room lies to the north of your bedroom.

You can see a bed and a bedroom window here.

It's been six minutes. It is eleven minutes past eight.

* * *

>l
Bedroom
Your bed is perfectly made. Outside the window, you can see the sun setting on the Manhattan skyline, bleeding orange onto you. The living room lies to the north of your bedroom.

You can see a bed and a bedroom window here.

What do you do this moment?

>l
Bedroom
Your bed is perfectly made. Outside the window, you can see the sun setting on the Manhattan skyline, bleeding orange onto you. The living room lies to the north of your bedroom.

You can see a bed and a bedroom window here.

It's been twenty-five minutes. It is twelve minutes past seven.

>l
Bedroom
Your bed is perfectly made. Outside the window, you can see the sun setting on the Manhattan skyline, bleeding orange onto you. The living room lies to the north of your bedroom.

You can see a bed and a bedroom window here.

It's been sixteen minutes. It is twenty-nine minutes past seven.

>l
Bedroom
Your bed is perfectly made. Outside the window, you can see the beautiful Manhattan skyline at night like a million stars. The living room lies to the north of your bedroom.

You can see a bed and a bedroom window here.

It's been nine minutes. It is twenty-one minutes to eight.

>x bed
Tidy and perfect; you probably could sink into it.

It's been twenty-one minutes. It is one minute past eight.

>sink into bed
You fall onto the bed, as it engulps you.
Ah. It's soft. You could stay here forever.
You get up again. You've been in bed for far too long.

It's been eleven minutes. It is thirteen minutes past eight.

>n
Living Room
Mostly bare, just the way you wanted it yesterday. An armchair sits next to the window. The bedroom lies to the south, and a door lies to the east.

You can see a Living Room window and an armchair (empty) here.

It's been twenty-six minutes. It is twenty to nine.

>x window
You see nothing special about the Living Room window.

It's been eight minutes. It is eleven minutes to nine.

* * *

>l
Bedroom
Your bed is perfectly made. Outside the window, you can see the sun setting on the Manhattan skyline, bleeding orange onto you. The living room lies to the north of your bedroom.

You can see a bed and a bedroom window here.

What do you do this moment?

>n
Living Room
Mostly bare, just the way you wanted it yesterday. An armchair sits dead center, facing the window.  The bedroom lies to the south.

You can see a living room window and an armchair here.

What do you do this moment?

>sit
What do you want to sit on?

What do you do this moment?

>chair
You touch the fabric of the chair, and memories of being with your family flood back to you. You sit down. The smoky smell reminds you of your grandfather, and the way he always smiled at you when you walked by. You lean back and close your eyes to take in a deep breath. Your grandfather passed when you were fifteen. It'll be your turn soon. 
You open your eyes and turn towards your room, wanting to look around.

You wanted this room earlier today. It reminds you of the emptiness of life, and your impending death. 
You just want to close your eyes and wait here.

What do you do this moment?

>z
Breathe, you tell yourself. In the silence, the clock ticks.

Time passes.

What do you do this moment?

>z
Breathe, you tell yourself. In the silence, the clock ticks.

Time passes.

What do you do this moment?

* * *

>x clock
Your mother taught you how to read an analog clock; how 21st century she was. Do you remember how to read an analog clock?

>yes
She was a good teacher, despite not being a good mother. 
You take a deep breath. Still, you miss her. Her laughter was contagious. Her love, although conditional, was abundant. She wouldn't want to see you like this. 

You miss her.

With your mother in your mind and heart, you're reminded that you have until seven o'clock tomorrow morning, when you, too, will pass and join her.

Well, time sure flies. The clock reads fourteen minutes past seven.

What do you do this moment?

>l
Living Room (on the armchair)
Mostly bare, but it's beginning to remind you of something. An armchair sits dead center, facing the window. The clock ticks, signaling the passage of time. The bedroom lies to the south.

You can see a clock and a living room window here.

What do you do this moment?

>jump
You jump on the spot.

What do you do this moment?

>x clock
Ah, time. For thousands of years, humankind worried about their limited lifespan. But no more. In the last century, the advancements in medicine have allowed wealthy people to streamline the ability to live forever. The layman's explanation? The cells are told to stop aging, and failed organs are replaced with artificial ones.
 
And it was a simple decision, really. 
You can remember the exact layout of your desk, years ago, when you made the decision. You turn around and see it just the way it was that day, in the corner of the room.
Well, time sure flies. The clock reads eighteen minutes to eight.
What do you do this moment?

>x clock
Well, time sure flies. The clock reads twenty-four minutes past eight.
What do you do this moment?

>tap laptop
There's only one button to tap, and it reads "Sign Up Now." You should probably read what's on the laptop first, though.
Tap it?

>y
This is what you wanted. To live forever, so you can love forever, and never leave anyone behind. Your child, your grandchild, and your great-grandchild will never have to know loss. 

How wrong you were. Why did I click it? Here you are now, waiting out the last few moments of life. Intentionally waiting for someone to put you down, like a dog. You chuckle in the silence as tears stream down your face. 
This is the end. There's only one thing left for me to do here. It's already twenty-five past eight.

What do you do this moment?

>l
Living Room (on the armchair)
The room is filled with the objects of your life. An armchair sits dead center, facing the window. The clock ticks, signaling the passage of time. The bedroom lies to the south.

You can see a desk (on which is a letter), a clock and a living room window here.

What do you do this moment?

* * *

>l
Living Room (on the armchair)
Mostly bare, just the way you wanted it yesterday. An armchair sits dead center, facing the window.  The bedroom lies to the south.

You can see a living room window here.

What do you do this moment?

>close eyes
Breathe, you tell yourself. In the silence, the clock ticks.

Time passes.

What do you do this moment?

>breathe
Breathe, you tell yourself. In the silence, the clock ticks.

Time passes.

What do you do this moment?

>breathe
Breathe, you tell yourself. In the silence, the clock ticks.

Time passes.

What do you do this moment?

>x clock
Your mother taught you how to read an analog clock; how 21st century she was. Do you remember how to read an analog clock?

>y
She was a good teacher, despite not being a good mother. 
You take a deep breath. Still, you miss her. Her laughter was contagious. Her love, although conditional, was abundant. She wouldn't want to see you like this. 

You miss her.

With your mother in your mind and heart, you're reminded that you have until seven o'clock tomorrow morning, when you, too, will pass and join her.

Well, time sure flies. The clock reads half past seven.

What do you do this moment?

>l
Living Room (on the armchair)
Mostly bare, but it's beginning to remind you of something. An armchair sits dead center, facing the window. The clock ticks, signaling the passage of time. The bedroom lies to the south.

You can see a clock and a living room window here.

What do you do this moment?

>l
Living Room (on the armchair)
Mostly bare, but it's beginning to remind you of something. An armchair sits dead center, facing the window. The clock ticks, signaling the passage of time. The bedroom lies to the south.

You can see a clock and a living room window here.

What do you do this moment?

>z
You wait, patiently. 
Time passes.

What do you do this moment?

>x clock
Ah, time. For thousands of years, humankind worried about their limited lifespan. But no more. In the last century, the advancements in medicine have allowed wealthy people to streamline the ability to live forever. The layman's explanation? The cells are told to stop aging, and failed organs are replaced with artificial ones.
 
And it was a simple decision, really. 
You can remember the exact layout of your desk, years ago, when you made the decision. You turn around and see it just the way it was that day, in the corner of the room.
Well, time sure flies. The clock reads twenty past nine.
What do you do this moment?

>l
Living Room (on the armchair)
The room is filled with the objects of your life. An armchair sits dead center, facing the window. The clock ticks, signaling the passage of time. The bedroom lies to the south.

You can see a desk (on which are a shredder (empty), a laptop and a letter), a clock and a living room window here.

What do you do this moment?

>read letter
The letter reads:
"Babe, I love you. 
The words "I'm sorry" was scribbled out, but you can still see it underneath the ink marks. "Thank you. For everything. For all the loving moments." Continue?

* * *

>y
Still, you wipe away the tears, and read on. "Lastly, mourn for me. Cry, punch, scream, write; whatever you need. 
Then move on." Continue?

>y
"I will always love you; but please, move on. For yourself, for me, for our child. 
Forever yours. 
Your wife, 

Kate In-young Dessalegn."
Your legs give out beneath you, and you break down in tears. You just need a moment to be okay.

What do you do this moment?

>l
Living Room (on the armchair)
The room is filled with the objects of your life. An armchair sits dead center, facing the window. The clock ticks, signaling the passage of time. The bedroom lies to the south.

You can see a desk (on which are a shredder (empty), a laptop and a letter), a clock and a living room window here.

I am potatoes
What do you do this moment?

>z
You wait, patiently. 
Time passes.

What do you do this moment?

>z
You wait, patiently. 
Time passes.

What do you do this moment?

>yes
That was a rhetorical question.

What do you do this moment?

>ls
That's not a verb I recognise.

What do you do this moment?

>l
Living Room (on the armchair)
The room is filled with the objects of your life. An armchair sits dead center, facing the window. The clock ticks, signaling the passage of time. The bedroom lies to the south.

You can see a desk (on which are a shredder (empty), a laptop and a letter), a clock and a living room window here.

What do you do this moment?

>ACTIONS
Actions listing on.

What do you do this moment?

>ls
That's not a verb I recognise.

What do you do this moment?

>y
[saying yes]
That was a rhetorical question.
[saying yes - failed the block saying yes rule]

What do you do this moment?

>l
[looking]
Living Room (on the armchair)
The room is filled with the objects of your life. An armchair sits dead center, facing the window. The clock ticks, signaling the passage of time. The bedroom lies to the south.

You can see a desk (on which are a shredder (empty), a laptop and a letter), a clock and a living room window here.

[looking - succeeded]

What do you do this moment?

>jump
[jumping]
You jump on the spot.
[jumping - succeeded]

What do you do this moment?

>kill myself
[killing yourself]
You don't quite think it's time yet.
[killing yourself - ended without result]

What do you do this moment?

>l
[looking]
Living Room (on the armchair)
The room is filled with the objects of your life. An armchair sits dead center, facing the window. The clock ticks, signaling the passage of time. The bedroom lies to the south.

You can see a desk (on which are a shredder (empty), a laptop and a letter), a clock and a living room window here.

[looking - succeeded]

What do you do this moment?

>x clock
[examining the clock]
Well, time sure flies. The clock reads twenty-seven minutes to two.[examining the clock - ended without result]

What do you do this moment?

>tap laptop
[touching the laptop]
There's only one button to tap, and it reads "Sign Up Now." You should probably read what's on the laptop first, though.
Tap it?

>y
This is what you wanted. To live forever, so you can love forever, and never leave anyone behind. Your child, your grandchild, and your great-grandchild will never have to know loss. 

How wrong you were. Why did I click it? Here you are now, waiting out the last few moments of life. Intentionally waiting for someone to put you down, like a dog. You chuckle in the silence as tears stream down your face. 
This is the end. There's only one thing left for me to do here. It's already twenty-six minutes to two.
[touching the laptop - failed]

What do you do this moment?

>l
[looking]
Living Room (on the armchair)
The room is filled with the objects of your life. An armchair sits dead center, facing the window. The clock ticks, signaling the passage of time. The bedroom lies to the south.

You can see a desk (on which is a letter), a clock and a living room window here.

[looking - succeeded]

What do you do this moment?

>kill myself
[killing yourself]
You're getting rather tired. The bed must be nearby.
[killing yourself - ended without result]

What do you do this moment?

>ACTIONS
Actions listing on.

What do you do this moment?

>ACTIONS OFF
Actions listing off.

What do you do this moment?

>l
Living Room (on the armchair)
The room is filled with the objects of your life. An armchair sits dead center, facing the window. The clock ticks, signaling the passage of time. The bedroom lies to the south.

You can see a desk (on which is a letter), a clock and a living room window here.

What do you do this moment?

>z
You wait, patiently. You look around for the bed.

Time passes.

What do you do this moment?

>z
You wait, patiently. You look around for the bed.

Time passes.

What do you do this moment?

>ns
That's not a verb I recognise.

What do you do this moment?

>s
(first getting off the armchair)

Bedroom
Your bed is perfectly made. Outside the window, you can see the beautiful Manhattan skyline at night like a million stars. The living room lies to the north of your bedroom.

You can see a bed and a bedroom window here.

What do you do this moment?

>z
You wait, patiently. You look around for the bed.

Time passes.

What do you do this moment?

* * *

>l
Bedroom
Your bed is perfectly made. Outside the window, you can see the sun setting on the Manhattan skyline, bleeding orange onto you. The living room lies to the north of your bedroom.

You can see a bed and a bedroom window here.

What do you do this moment?

>x window
Outside, Manhattan glitters gold beneath you. Everything is perfect. 

What do you do this moment? 50

>x bed
Tidy and perfect; you probably could sink into it. 

What do you do this moment? 50

>sink into bed
You fall onto the bed, as it engulfs you. 
Ah. It's soft. You could stay here forever.

You get up again, though. There's a time and place for everything. But not now.

What do you do this moment? 50

>n
Living Room
Mostly bare, just the way you wanted it yesterday. An armchair sits dead center, facing the window.  The bedroom lies to the south.

You can see a living room window and an armchair here.

What do you do this moment? 50

>sit in chair
You touch the fabric of the chair, and memories of being with your family flood back to you. You sit down. The smoky smell reminds you of your grandfather, and the way he always smiled at you when you walked by. You lean back and close your eyes to take in a deep breath. Your grandfather passed when you were fifteen. It'll be your turn soon. 
You open your eyes and turn towards your room, wanting to look around.

You wanted this room like this. It reminds you of the emptiness of life, and your impending death. 
You just want to close your eyes and wait here.

What do you do this moment? 50

>z
Breathe, you tell yourself. In the silence, the clock ticks.

Time passes.

What do you do this moment? 50

>n
(first getting off the armchair)
You can't go that way.

What do you do this moment? 50

>l
Living Room
Mostly bare, just the way you wanted it yesterday. An armchair sits dead center, facing the window.  The bedroom lies to the south.

You can see a clock, a living room window and an armchair here.

What do you do this moment? 50

>z
Breathe, you tell yourself. In the silence, the clock ticks.

Time passes.

What do you do this moment? 50

>tick
That's not a verb I recognise.

What do you do this moment? 50

>clock
That's not a verb I recognise.

What do you do this moment? 50

>x clock
Your mother taught you how to read an analog clock. How 21st century she was. Do you remember how to read an analog clock?

>no
The memory of your mother makes your blood boil; she was never there for you. She was a terrible teacher, and an even worse mother. She stopped making dinner for the family when you were 6. She stopped picking you up from school when you were 9. She forgot your 13th birthday, and every birthday after that. 
    Breathe.
Her birth date is July 29th, 2003. 
    Breathe.
She's a Leo. Your grandfather was also a Leo. You miss him. 
    Breathe.
You regain some composure, as your mind wandered back to him.
With your grandfather in your mind and heart, you're reminded that you have until 7:00 am tomorrow, when you, too, will pass and join him.

Well, time sure flies. The clock reads 6:49 pm.

What do you do this moment? 25

>l
Living Room
Mostly bare, but it's beginning to remind you of something. An armchair sits dead center, facing the window. The clock ticks, signaling the passage of time. The bedroom lies to the south.

You can see a clock, a living room window and an armchair here.

What do you do this moment? 25

>x clock
Ah, time. For thousands of years, humankind worried about their limited lifespan. But no more. In the last century, the advancements in medicine have allowed wealthy people to streamline the ability to live forever. The layman's explanation? The cells are told to stop aging, and failed organs are replaced with artificial ones.
 
And it was a simple decision, really. 
You can remember the exact layout of your desk, years ago, when you made the decision. You turn around and see it just the way it was that day, in the corner of the room. Well, time sure flies. The clock reads 8:10 pm.
What do you do this moment? 25

>l
Living Room
The room is filled with the objects of your life. An armchair sits dead center, facing the window. The clock ticks, signaling the passage of time. The bedroom lies to the south.

You can see a desk (on which are a shredder (empty), a laptop and a letter), a clock, a living room window and an armchair here.

What do you do this moment? 25

>read letter
The letter reads:
"Babe, I love you. 
The words "I'm sorry" was scribbled out, but you can still see it underneath the ink marks. "Thank you. For everything. For all the loving moments." Continue?

* * *

>z
You wait, patiently. 
Time passes.

Breathe, you tell yourself. You wipe away the tears, regain control of your legs and arms, and pull yourself up. You look at the letter in your hand.

What do you do this moment? 25

>z
You wait, patiently. 
Time passes.

What do you do this moment? 25

>look
Living Room
The room is filled with the objects of your life. An armchair sits dead center, facing the window. The clock ticks, signaling the passage of time. The bedroom lies to the south.

You can see a desk (on which are a shredder (empty), a laptop and a letter), a clock, a living room window and an armchair here.

What do you do this moment? 25

>shred laptop
What do you do this moment? 25

>l
Living Room
The room is filled with the objects of your life. An armchair sits dead center, facing the window. The clock ticks, signaling the passage of time. The bedroom lies to the south.

You can see a desk (on which are a shredder (empty), a laptop and a letter), a clock, a living room window and an armchair here.

What do you do this moment? 25

>shred letter
Are you sure you want to shred the letter?

>y
Feeling betrayed, you put the letter into the shredder. 
"Bbbbbbbbbshhhhhhzzzzzzzzzzzzzzzzzzzz," the shredder hummed.

The letter is now completely destroyed, just like it was before, when you first read it years ago.
How could she? You thought to yourself back then. She didn't even fight it; she just accepted her death, and let the illness take her. You turn to the laptop, and you remembered how you found yourself here.

What do you do this moment? 25

>l
Living Room
The room is filled with the objects of your life. An armchair sits dead center, facing the window. The clock ticks, signaling the passage of time. The bedroom lies to the south.

You can see a desk (on which are a shredder (in which is a shredded letter) and a laptop), a clock, a living room window and an armchair here.

What do you do this moment? 25

>take shredded letter out
I only understood you as far as wanting to take the shredded letter.

What do you do this moment? 25

>take shredded letter
Taken.

What do you do this moment? 25

>read shredded letter
Just the shredded handwriting of your wife.

What do you do this moment? 25

>read letter
Just the shredded handwriting of your wife.

What do you do this moment? 25

>kill self
You don't quite think it's time yet.

What do you do this moment? 25

>touch laptop
There's only one button to tap, and it reads "Sign Up Now." You should probably read what's on the laptop first, though.
Tap it?

>n
What do you do this moment? 25

>read laptop
August 10th, 2057 
Dear friend, welcome to the future. My name is Steven Musk, founder of Elon Tech. If you are here, you know we have mastered death.  
I'm proud to announce that today, Elon Tech will open up this technology to the public, allowing anyone to be able to extend their lives indefinitely.  Join the human evolution with me. Subscribe below.

Sign Up Now
What do you do this moment? 25

>read
(the shredded letter)
Just the shredded handwriting of your wife.

What do you do this moment? 25

>read laptpo
You can't see any such thing.

What do you do this moment? 25

>tap laptop
There's only one button to tap, and it reads "Sign Up Now." Tap it?

>y
This is what you wanted. To live forever, so you can love forever, and never leave anyone behind. Your child, your grandchild, and your great-grandchild will never have to know loss. 

How wrong you were. Why did I click it? Here you are now, waiting out the last few moments of life. Intentionally waiting for someone to put you down, like a dog. You chuckle in the silence as tears stream down your face. 
This is the end. There's only one thing left for me to do here. It's already 12:56 am.

What do you do this moment? 40

>l
Living Room
The room is filled with the objects of your life. An armchair sits dead center, facing the window. The clock ticks, signaling the passage of time. The bedroom lies to the south.

You can see a desk, a clock, a living room window and an armchair here.

What do you do this moment? 40

>kill self
You're getting rather tired. The bed must be nearby.

What do you do this moment? 40

>l
Living Room
The room is filled with the objects of your life. An armchair sits dead center, facing the window. The clock ticks, signaling the passage of time. The bedroom lies to the south.

You can see a desk, a clock, a living room window and an armchair here.

What do you do this moment? 40

>l
Living Room
The room is filled with the objects of your life. An armchair sits dead center, facing the window. The clock ticks, signaling the passage of time. The bedroom lies to the south.

You can see a desk, a clock, a living room window and an armchair here.

What do you do this moment? 40

>s
Bedroom
Your bed is perfectly made for you. Outside the window, you can see the beautiful Manhattan skyline at night like a million stars. The living room lies to the north of your bedroom.

You can see a bed and a bedroom window here.

What do you do this moment? 40

>x bed
Tidy and perfect; you probably could sink into it. A good place to end, you think.

What do you do this moment? 40

>sink into bed
You fall onto the bed, as it engulfs you. 
Ah. It's soft. You could stay here forever.
You close your eyes, crying. You miss them so much. Everyone you loved, dying one by one. Everyone dies. It's your turn. You won't wake again.

    *** The End ***

Would you like to RESTART, RESTORE a saved game, QUIT or UNDO the last command?

>undo
Bedroom
[Previous turn undone.]

What do you do this moment? 40

>z
You wait, patiently. You look around for the bed.

Time passes.

What do you do this moment? 40

>z
You wait, patiently. You look around for the bed.

Time passes.

What do you do this moment? 40

>z
You wait, patiently. You look around for the bed.

Time passes.

Your strength suddenly fades. Your time is up.  You miss them so much. Everyone you loved, dying one by one. Everyone dies. It's your turn. Why was I born? You won't wake again.

    *** The End ***

Would you like to RESTART, RESTORE a saved game, QUIT or UNDO the last command?

>z
Please give one of the answers above.

Would you like to RESTART, RESTORE a saved game, QUIT or UNDO the last command?

>n
Please give one of the answers above.

Would you like to RESTART, RESTORE a saved game, QUIT or UNDO the last command?

>x clock
Please give one of the answers above.

Would you like to RESTART, RESTORE a saved game, QUIT or UNDO the last command?

* * *

>l
Bedroom
Your bed is perfectly made. Outside the window, you can see the sun setting on the Manhattan skyline, bleeding orange onto you. The living room lies to the north of your bedroom.

You can see a bed and a bedroom window here.

What do you do this moment?

>undo
Bedroom
[Previous turn undone.]

What do you do this moment?

>x clock
You can't see any such thing.

What do you do this moment?

* * *

>x
What do you want to examine?

>z
It's been fifteen minutes. It is eight minutes to seven. Y.

>z
It's been twelve minutes. It is five past seven. Y.

>z
It's been six minutes. It is twelve minutes past seven. Y.

>z
It's been three minutes. It is sixteen minutes past seven. Y.

>z
It's been twenty-nine minutes. It is fourteen minutes to eight. Y.

>z
It's been twenty-nine minutes. It is sixteen minutes past eight. X

>z
It's been eight minutes. It is twenty-five past eight. X

>z
It's been two minutes. It is twenty-eight minutes past eight. X

I beg your pardon?

>z
It's been twenty-two minutes. It is ten past nine. Y

>z
It's been nineteen minutes. It is half past nine. Y

>z
It's been seven minutes. It is twenty-two minutes to ten. Y

>z
It's been twenty-one minutes. It is ten o'clock. Y

* * *

>play music
That's not a verb I recognise.

>n
Living Room
Mostly bare, just the way you wanted it yesterday. An armchair sits next to the window. The bedroom lies to the south.

You can see a living room window and an armchair (empty) here.

It's been fifty-nine minutes. It is twenty-five to eight.

>sit in chair
Memories of being with your family flood back to you. The smoky smell reminds you of your grandfather, and the way he always smiled at you when you walked by. You lean back and close your eyes to take in a deep breath. Your grandfather passed when you were fifteen. It'll be your turn soon. 
You turn towards your room, wanting to look around.

It's been eleven minutes. It is fourteen minutes to eight.

>sit in armchair
But you're already in the armchair.

It's been five minutes. It is nine minutes to eight.

>p
That's not a verb I recognise.

>l
Living Room (in the armchair)
Mostly bare, just the way you wanted it yesterday. An armchair sits next to the window. The bedroom lies to the south.

You can see a living room window here.

It's been eighteen minutes. It is nine minutes past eight.

>l
Living Room (in the armchair)
Mostly bare, just the way you wanted it yesterday. An armchair sits next to the window. The bedroom lies to the south.

You can see a living room window here.

It's been four minutes. It is thirteen minutes past eight.

I beg your pardon?

>l
Living Room (in the armchair)
Mostly bare, just the way you wanted it yesterday. An armchair sits next to the window. The bedroom lies to the south.

You can see a living room window here.

It's been fifteen minutes. It is twenty-eight minutes past eight.

* * *

>enter bed
You fall onto the bed, as it engulps you. 
Ah. It's soft. You could stay here forever. 
You get up again, though. There's a time and place for everything. But not now.

>n
Living Room
Mostly bare, just the way you wanted it yesterday. An armchair sits dead center, facing the window. The bedroom lies to the south.

You can see a living room window and an armchair here.

>sit on chair
You touch the fabric of the chair, and memories of being with your family flood back to you. You sit down. The smoky smell reminds you of your grandfather, and the way he always smiled at you when you walked by. You lean back and close your eyes to take in a deep breath. Your grandfather passed when you were fifteen. It'll be your turn soon. 
You open your eyes and turn towards your room, wanting to look around.

* * *

>x bed\
You can't see any such thing.

>x bed
This apparently is a clockYour mother taught you how to read an analog clock; how 21th century she was. Do you remember how to read an analog clock?

* * *

>touch bed
You feel nothing unexpected.

>no
That was a rhetorical question.

>n
Living Room
Mostly bare, just the way you wanted it yesterday. An armchair sits dead center, facing the window. The bedroom lies to the south.

You can see a living room window and an armchair here.

>touch clock
You can't see any such thing.

* * *

>sit
What do you want to sit on?

>sit on chair
But you're already on the armchair.

>>exit
That's not a verb I recognise.

* * *

>touch bed
You feel nothing unexpected.

>n
Living Room
Mostly bare, just the way you wanted it yesterday. An armchair sits dead center, facing the window. The bedroom lies to the south.

You can see a living room window and an armchair here.

>touch armchair
You feel nothing unexpected.

* * *

>bed
That's not a verb I recognise.

>x bed
Tidy and perfect; you probably could sink into it.

>touch bed
You feel nothing unexpected.

* * *

>n
Living Room
Mostly bare, just the way you wanted it yesterday. An armchair sits dead center, facing the window. The bedroom lies to the south.

You can see a living room window and an armchair here.

>x armchair
It's a perfect replica of the same one your grandfather owned. It even smells of old cigarette smoke.

>touch armchair
You touch the fabric of the chair, and memories of being with your family flood back to you. You sit down. The smoky smell reminds you of your grandfather, and the way he always smiled at you when you walked by. You lean back and close your eyes to take in a deep breath. Your grandfather passed when you were fifteen. It'll be your turn soon. 
You open your eyes and turn towards your room, wanting to look around.

You wanted this room earlier today. It reminds you of the emptiness of life, and your impending death. 
You just want to close your eyes and wait here.

>sit armchair
I didn't understand that sentence.

>sit on armchair
But you're already on the armchair.

>ls
That's not a verb I recognise.

>l
Living Room (on the armchair)
Mostly bare, just the way you wanted it yesterday. An armchair sits dead center, facing the window. The bedroom lies to the south.

You can see a living room window here.

>z
Breathe, you tell yourself. In the silence, the clock ticks.

Time passes.

* * *

>x clock
Your mother taught you how to read an analog clock; how 21st century she was. Do you remember how to read an analog clock?

>n
The memory of your mother makes your blood boil; she was never there for you. She was a terrible teacher, and an even worse mother. She stopped making dinner for the family when you were 6. She stopped picking you up from school when you were 9. She forgot your 13th birthday, and every birthday after that. 
    Breathe.
Her birth date is July 29th, 2003. 
    Breathe.
She's a Leo. Your grandfather was also a Leo. You miss him. 
    Breathe.
You regain some composure, as your mind wandered back to him.
With your grandfather in your mind and heart, you're reminded that you have until 7:00 am tomorrow, when you, too, will pass and join him.

Well, time sure flies. The clock reads 6:47 pm.

>look
Living Room (on the armchair)
Mostly bare, just the way you wanted it yesterday. An armchair sits dead center, facing the window. The bedroom lies to the south.

You can see a clock and a living room window here.

>look
Living Room (on the armchair)
Mostly bare, just the way you wanted it yesterday. An armchair sits dead center, facing the window. The bedroom lies to the south.

You can see a clock and a living room window here.

* * *

>x me
You look just the way you want to.

* * *

>look window
Outside, Manhattan glitters gold beneath you. Everything is perfect.

>look bed
Tidy and perfect; you probably could sink into it.

>go north
Living Room
Mostly bare, just the way you wanted it yesterday. An armchair sits dead center, facing the window. The bedroom lies to the south.

You can see a living room window and an armchair here.

>look armchair
It's a perfect replica of the same one your grandfather owned. It even smells of old cigarette smoke.

>look window
Outside, Manhattan glitters gold beneath you. Everything is perfect.

>go outside
You can't go that way.

>go south
Bedroom
Your bed is perfectly made. Outside the window, you can see the sun setting on the Manhattan skyline, bleeding orange onto you. The living room lies to the north of your bedroom.

You can see a bed and a bedroom window here.

>go living room
You can't see any such thing.

>go north
Living Room
Mostly bare, just the way you wanted it yesterday. An armchair sits dead center, facing the window. The bedroom lies to the south.

You can see a living room window and an armchair here.

>push armchair out of window
I only understood you as far as wanting to push the armchair outside.

>push armchair outside
The armchair cannot be pushed from place to place.

>look
Living Room
Mostly bare, just the way you wanted it yesterday. An armchair sits dead center, facing the window. The bedroom lies to the south.

You can see a living room window and an armchair here.

>go s
Bedroom
Your bed is perfectly made. Outside the window, you can see the sun setting on the Manhattan skyline, bleeding orange onto you. The living room lies to the north of your bedroom.

You can see a bed and a bedroom window here.

>look bed
Tidy and perfect; you probably could sink into it.

>x bed
Tidy and perfect; you probably could sink into it.

>go to bed
You can't see any such thing.

>enter bed
You fall onto the bed, as it engulps you. 
Ah. It's soft. You could stay here forever. 
You get up again, though. There's a time and place for everything. But not now.

>ls
That's not a verb I recognise.

>look
Bedroom
Your bed is perfectly made. Outside the window, you can see the sun setting on the Manhattan skyline, bleeding orange onto you. The living room lies to the north of your bedroom.

You can see a bed and a bedroom window here.

>go n
Living Room
Mostly bare, just the way you wanted it yesterday. An armchair sits dead center, facing the window. The bedroom lies to the south.

You can see a living room window and an armchair here.

>l
Living Room
Mostly bare, just the way you wanted it yesterday. An armchair sits dead center, facing the window. The bedroom lies to the south.

You can see a living room window and an armchair here.

>l
Living Room
Mostly bare, just the way you wanted it yesterday. An armchair sits dead center, facing the window. The bedroom lies to the south.

You can see a living room window and an armchair here.

>enter armchair
You touch the fabric of the chair, and memories of being with your family flood back to you. You sit down. The smoky smell reminds you of your grandfather, and the way he always smiled at you when you walked by. You lean back and close your eyes to take in a deep breath. Your grandfather passed when you were fifteen. It'll be your turn soon. 
You open your eyes and turn towards your room, wanting to look around.

You wanted this room earlier today. It reminds you of the emptiness of life, and your impending death. 
You just want to close your eyes and wait here.

>l
Living Room (on the armchair)
Mostly bare, just the way you wanted it yesterday. An armchair sits dead center, facing the window. The bedroom lies to the south.

You can see a living room window here.

>l
Living Room (on the armchair)
Mostly bare, just the way you wanted it yesterday. An armchair sits dead center, facing the window. The bedroom lies to the south.

You can see a living room window here.

>wait
Breathe, you tell yourself. In the silence, the clock ticks.

Time passes.

>wait
You wait, patiently.

Time passes.

>wait
You wait, patiently.

Time passes.

>l
Living Room (on the armchair)
Mostly bare, just the way you wanted it yesterday. An armchair sits dead center, facing the window. The bedroom lies to the south.

You can see a clock and a living room window here.

>l
Living Room (on the armchair)
Mostly bare, just the way you wanted it yesterday. An armchair sits dead center, facing the window. The bedroom lies to the south.

You can see a clock and a living room window here.

>wait
You wait, patiently.

Time passes.

>exit chair
I only understood you as far as wanting to exit.

>exit
You get off the armchair.

Living Room
Mostly bare, just the way you wanted it yesterday. An armchair sits dead center, facing the window. The bedroom lies to the south.

You can see a clock, a living room window and an armchair here.

>wait
You wait, patiently.

Time passes.

>l
Living Room
Mostly bare, just the way you wanted it yesterday. An armchair sits dead center, facing the window. The bedroom lies to the south.

You can see a clock, a living room window and an armchair here.

>go south
Bedroom
Your bed is perfectly made. Outside the window, you can see the sun setting on the Manhattan skyline, bleeding orange onto you. The living room lies to the north of your bedroom.

You can see a bed and a bedroom window here.

>go n
Living Room
Mostly bare, just the way you wanted it yesterday. An armchair sits dead center, facing the window. The bedroom lies to the south.

You can see a clock, a living room window and an armchair here.

>go s
Bedroom
Your bed is perfectly made. Outside the window, you can see the sun setting on the Manhattan skyline, bleeding orange onto you. The living room lies to the north of your bedroom.

You can see a bed and a bedroom window here.

>go n
Living Room
Mostly bare, just the way you wanted it yesterday. An armchair sits dead center, facing the window. The bedroom lies to the south.

You can see a clock, a living room window and an armchair here.

>x clock
Your mother taught you how to read an analog clock; how 21st century she was. Do you remember how to read an analog clock?

>yes
She was a good teacher, despite not being a good mother. 
You take a deep breath. Still, you miss her. Her laughter was contagious. Her love, although conditional, was abundant. She wouldn't want to see you like this. 

You miss her.

With your mother in your mind and heart, you're reminded that you have until seven o'clock tomorrow morning, when you, too, will pass and join her.

Well, time sure flies. The clock reads ten to eight.

>look
Living Room
Mostly bare, just the way you wanted it yesterday. An armchair sits dead center, facing the window. The bedroom lies to the south.

You can see a clock, a living room window and an armchair here.

>wait
You wait, patiently.

Time passes.

>x clock
Well, time sure flies. The clock reads two minutes to nine.

>wait
You wait, patiently.

Time passes.

>x cock
You can't see any such thing.

>x clock
Well, time sure flies. The clock reads twenty-five past nine.

>x clock
Well, time sure flies. The clock reads one minute past ten.

>x clock
Well, time sure flies. The clock reads five to eleven.

>x clock
Well, time sure flies. The clock reads twenty-two minutes to twelve.

>x clock
Well, time sure flies. The clock reads half past twelve.

>x clock
Well, time sure flies. The clock reads nine minutes past one.

>x clock
Well, time sure flies. The clock reads twenty-six minutes to two.

>x clock
Well, time sure flies. The clock reads twenty-eight minutes past two.

>go s
Bedroom
Your bed is perfectly made. Outside the window, you can see the beautiful Manhattan skyline at night like a million stars. The living room lies to the north of your bedroom.

You can see a bed and a bedroom window here.

>enter bed
You fall onto the bed, as it engulps you. 
Ah. It's soft. You could stay here forever. 
You get up again, though. There's a time and place for everything. But not now.

>l
Bedroom
Your bed is perfectly made. Outside the window, you can see the beautiful Manhattan skyline at night like a million stars. The living room lies to the north of your bedroom.

You can see a bed and a bedroom window here.

>go n
Living Room
Mostly bare, just the way you wanted it yesterday. An armchair sits dead center, facing the window. The bedroom lies to the south.

You can see a clock, a living room window and an armchair here.

>x window
Outside, Manhattan looks like a sea of fireflies, blinking beneath you. Everything is perfect.

>x armchair
It's a perfect replica of the same one your grandfather owned. It even smells of old cigarette smoke.

>x clock
Well, time sure flies. The clock reads nine minutes past five.

>wait
You wait, patiently.

Time passes.

>x clock
Well, time sure flies. The clock reads thirteen minutes past six.

>wait
You wait, patiently.

Time passes.

>x clock
Well, time sure flies. The clock reads twenty-seven minutes past seven.

It's time...

    *** The End ***

Would you like to RESTART, RESTORE a saved game, QUIT or UNDO the last command?

* * *

>look at bed
Tidy and perfect; you probably could sink into it.

>look at window
Outside, Manhattan glitters gold beneath you. Everything is perfect.

>go north
Living Room
Mostly bare, just the way you wanted it yesterday. An armchair sits dead center, facing the window. The bedroom lies to the south.

You can see a living room window and an armchair here.

>look at window
Outside, Manhattan glitters gold beneath you. Everything is perfect.

>look at armchair
It's a perfect replica of the same one your grandfather owned. It even smells of old cigarette smoke.

>n
You can't go that way.

>s
Bedroom
Your bed is perfectly made. Outside the window, you can see the sun setting on the Manhattan skyline, bleeding orange onto you. The living room lies to the north of your bedroom.

You can see a bed and a bedroom window here.

>n
Living Room
Mostly bare, just the way you wanted it yesterday. An armchair sits dead center, facing the window. The bedroom lies to the south.

You can see a living room window and an armchair here.

>look at self
You look down at yourself. You're wearing your best Sunday clothes, but it feels like wearing pajamas.

>go out
You can't go that way.

>sit
What do you want to sit on?

>sit on armchair
You touch the fabric of the chair, and memories of being with your family flood back to you. You sit down. The smoky smell reminds you of your grandfather, and the way he always smiled at you when you walked by. You lean back and close your eyes to take in a deep breath. Your grandfather passed when you were fifteen. It'll be your turn soon. 
You open your eyes and turn towards your room, wanting to look around.

You wanted this room earlier today. It reminds you of the emptiness of life, and your impending death. 
You just want to close your eyes and wait here.

>s
(first getting off the armchair)

Bedroom
Your bed is perfectly made. Outside the window, you can see the sun setting on the Manhattan skyline, bleeding orange onto you. The living room lies to the north of your bedroom.

You can see a bed and a bedroom window here.

>n
Living Room
Mostly bare, just the way you wanted it yesterday. An armchair sits dead center, facing the window. The bedroom lies to the south.

You can see a living room window and an armchair here.

* * *

>look at window
Outside, Manhattan glitters gold beneath you. Everything is perfect.

>look at bed
Tidy and perfect; you probably could sink into it.

>go north
Living Room
Mostly bare, just the way you wanted it yesterday. An armchair sits dead center, facing the window. The bedroom lies to the south.

You can see a living room window and an armchair here.

* * *

>n
You can't go that way.

>w
You can't go that way.

>e
You can't go that way.

>up
You can't go that way.

>down
You can't go that way.

>sit
What do you want to sit on?

* * *

>sit on armchair
You touch the fabric of the chair, and memories of being with your family flood back to you. You sit down. The smoky smell reminds you of your grandfather, and the way he always smiled at you when you walked by. You lean back and close your eyes to take in a deep breath. Your grandfather passed when you were fifteen. It'll be your turn soon. 
You open your eyes and turn towards your room, wanting to look around.

You wanted this room earlier today. It reminds you of the emptiness of life, and your impending death. 
You just want to close your eyes and wait here.

>look at self
You look down at yourself. You're wearing your best Sunday clothes, but it feels like wearing pajamas.

>look
Living Room (on the armchair)
Mostly bare, just the way you wanted it yesterday. An armchair sits dead center, facing the window. The bedroom lies to the south.

You can see a living room window here.

>z
Breathe, you tell yourself. In the silence, the clock ticks.

Time passes.

* * *

>view
What do you want to view?

>x
What do you want to examine?

>view bed
Tidy and perfect; you probably could sink into it.

>view window
Outside, Manhattan glitters gold beneath you. Everything is perfect.

>n
Living Room
Mostly bare, just the way you wanted it yesterday. An armchair sits dead center, facing the window. The bedroom lies to the south.

You can see a living room window and an armchair here.

>sit in chair
You touch the fabric of the chair, and memories of being with your family flood back to you. You sit down. The smoky smell reminds you of your grandfather, and the way he always smiled at you when you walked by. You lean back and close your eyes to take in a deep breath. Your grandfather passed when you were fifteen. It'll be your turn soon. 
You open your eyes and turn towards your room, wanting to look around.

You wanted this room earlier today. It reminds you of the emptiness of life, and your impending death. 
You just want to close your eyes and wait here.

>z
Breathe, you tell yourself. In the silence, the clock ticks.

Time passes.

* * *

>x clock
Your mother taught you how to read an analog clock; how 21st century she was. Do you remember how to read an analog clock?

>y
She was a good teacher, despite not being a good mother. 
You take a deep breath. Still, you miss her. Her laughter was contagious. Her love, although conditional, was abundant. She wouldn't want to see you like this. 

You miss her.

With your mother in your mind and heart, you're reminded that you have until seven o'clock tomorrow morning, when you, too, will pass and join her.

Well, time sure flies. The clock reads twelve minutes past seven.

>x clock
Ah, time. For thousands of years, humankind worried about their limited lifespan. But no more. In the last century, the advancements in medicine have allowed wealthy people to streamline the ability to live forever. The layman's explanation? The cells are told to stop aging, and failed organs are replaced with artificial ones.
 
 And it was a simple decision, really. 
 You can remember the exact layout of your desk, years ago. You turn around and see it just the way it was that day, in the corner of the room.

Well, time sure flies. The clock reads sixteen minutes to eight.

>l
Living Room (on the armchair)
Mostly bare, just the way you wanted it yesterday. An armchair sits dead center, facing the window. The bedroom lies to the south.

You can see a desk (on which are a shredder, a laptop and a letter), a clock and a living room window here.

>x laptop
You see nothing special about the laptop.

>x shredder
Despite its small size, it has turned many pieces of paper to dust.

>read letter
The letter reads:
"Babe, I love you. 
The words "I'm sorry" was scribbled out, but you can still see it underneath the ink marks. "Thank you. For everything. For all the loving moments." Continue?

* * *

>y
"Still, Be his friend and his dad. Take him to the baseball games or buy him makeup; whatever he's into." Continue?

Please answer yes or no.

>n
You put the letter down. Her words remind you of her too much.

>x letter
Wet blotches sporadically covered the piece of paper, making some of your wife's cursive handwriting difficult to read.

>read
What do you want to read?

>computer
You can't see any such thing.

>read laptop
On your computer

>read letter
The letter reads:
"Babe, I love you. 
The words "I'm sorry" was scribbled out, but you can still see it underneath the ink marks. "Thank you. For everything. For all the loving moments." Continue?

* * *

>y
"Still, Be his friend and his dad. Take him to the baseball games or buy him makeup; whatever he's into." Continue?

>y
"Love him. Love him again. Love him twice, so he can feel my love, too."
The text becomes a blur, but you blink a few times. More blotches appear on the letter. Continue?

>y
"Lastly, mourn for me. Cry, punch, scream, write; whatever you need. 
Then move on." It hurts just reading. Continue?

>y
"I will always love you; but please, move on. For yourself, for me, for our child. 
 
Forever yours. 
Your wife, 

Kate In-young Dessalegn" You reached the end of the letter. More blotches.

* * *

>y
That was a rhetorical question.

>y
That was a rhetorical question.

>l
Living Room (on the armchair)
Mostly bare, just the way you wanted it yesterday. An armchair sits dead center, facing the window. The bedroom lies to the south.

You can see a desk (on which are a shredder, a laptop and a letter), a clock and a living room window here.

* * *

>read laptop
On your computer

>hold letter
Taken.

>i
You are carrying:
  a letter

* * *

>ls
That's not a verb I recognise.

What do you do this moment?

>l
Bedroom
Your bed is perfectly made. Outside the window, you can see the sun setting on the Manhattan skyline, bleeding orange onto you. The living room lies to the north of your bedroom.

You can see a bed and a bedroom window here.

>x bed
Tidy and perfect; you probably could sink into it.

>x window
Outside, Manhattan glitters gold beneath you. Everything is perfect.

* * *

>x bed
Tidy and perfect; you probably could sink into it.

>sleep
You aren't feeling especially drowsy.

>n
Living Room
Mostly bare, just the way you wanted it yesterday. An armchair sits dead center, facing the window. The bedroom lies to the south.

You can see a living room window and an armchair here.

>x window
Outside, Manhattan glitters gold beneath you. Everything is perfect.

>armchair
That's not a verb I recognise.

>sit in armchair
You touch the fabric of the chair, and memories of being with your family flood back to you. You sit down. The smoky smell reminds you of your grandfather, and the way he always smiled at you when you walked by. You lean back and close your eyes to take in a deep breath. Your grandfather passed when you were fifteen. It'll be your turn soon. 
You open your eyes and turn towards your room, wanting to look around.

You wanted this room earlier today. It reminds you of the emptiness of life, and your impending death. 
You just want to close your eyes and wait here.

>stand up
You get off the armchair.

Living Room
Mostly bare, just the way you wanted it yesterday. An armchair sits dead center, facing the window. The bedroom lies to the south.

You can see a living room window and an armchair here.

>x window
Outside, Manhattan glitters gold beneath you. Everything is perfect.

>s
Bedroom
Your bed is perfectly made. Outside the window, you can see the sun setting on the Manhattan skyline, bleeding orange onto you. The living room lies to the north of your bedroom.

You can see a bed and a bedroom window here.

>x bed
Tidy and perfect; you probably could sink into it.

>n
Living Room
Mostly bare, just the way you wanted it yesterday. An armchair sits dead center, facing the window. The bedroom lies to the south.

You can see a living room window and an armchair here.

>z
Breathe, you tell yourself. In the silence, the clock ticks.

Time passes.

>look
Living Room
Mostly bare, just the way you wanted it yesterday. An armchair sits dead center, facing the window. The bedroom lies to the south.

You can see a clock, a living room window and an armchair here.

>clock
That's not a verb I recognise.

>x clock
Your mother taught you how to read an analog clock; how 21st century she was. Do you remember how to read an analog clock?

>y
She was a good teacher, despite not being a good mother. 
You take a deep breath. Still, you miss her. Her laughter was contagious. Her love, although conditional, was abundant. She wouldn't want to see you like this. 

You miss her.

With your mother in your mind and heart, you're reminded that you have until seven o'clock tomorrow morning, when you, too, will pass and join her.

Well, time sure flies. The clock reads fourteen minutes to seven.

>l
Living Room
Mostly bare, just the way you wanted it yesterday. An armchair sits dead center, facing the window. The bedroom lies to the south.

You can see a clock, a living room window and an armchair here.

>x clock
Ah, time. For thousands of years, humankind worried about their limited lifespan. But no more. In the last century, the advancements in medicine have allowed wealthy people to streamline the ability to live forever. The layman's explanation? The cells are told to stop aging, and failed organs are replaced with artificial ones.
 
 And it was a simple decision, really. 
 You can remember the exact layout of your desk, years ago, when you made the decision. You turn around and see it just the way it was that day, in the corner of the room.
Well, time sure flies. The clock reads twenty-three minutes to eight.

>l
Living Room
Mostly bare, just the way you wanted it yesterday. An armchair sits dead center, facing the window. The bedroom lies to the south.

You can see a desk (on which are a shredder, a laptop and a letter), a clock, a living room window and an armchair here.

>x desk
A clear, wooden desk, popular back in the 2030's.  You picked it out when you first got your own place. It brings back so many memories.

On the desk are a shredder, a laptop and a letter.

>x shreder
You can't see any such thing.

>x shredder
Despite its small size, this shredder will blend almost anything into dust.

>x laptop
You remember this website well .

>x letter
Your wife's cursive handwriting is difficult to read. Despite having read it a million times, you want to read it again

>read letter
The letter reads:
"Babe, I love you. 
The words "I'm sorry" was scribbled out, but you can still see it underneath the ink marks. "Thank you. For everything. For all the loving moments." Continue?

* * *

>y
"I'm sorry that I must leave you early. I'm sorry I must leave our child motherless early. But I know he will grow up to be amazing regardless; you certainly did." Continue?

Please answer yes or no.

>y
"Still, Be his friend and his dad. Take him to the baseball games or buy him makeup; whatever he's into." Continue?

* * *

>y
"Love him. Love him again. Love him twice, so he can feel my love, too."
The text becomes a blur as your eyes water and your hands shake.
Breathe. You don't want to keep reading. Continue?

Please answer yes or no.

>y
Still, you wipe away the tears, and read on. "Lastly, mourn for me. Cry, punch, scream, write; whatever you need. 
Then move on." Continue?

>y
"I will always love you; but please, move on. For yourself, for me, for our child. 
Forever yours. 
Your wife, 

Kate In-young Dessalegn."
 Your legs give out beneath you, and you break down in tears. You just need a moment to be okay.

>read clock
Well, time sure flies. The clock reads twenty-nine minutes to ten.
Breathe, you tell yourself. You wipe away the tears, regain control of your legs and arms, and pull yourself up. You look at the letter in your hand.

* * *

>ls
That's not a verb I recognise.

What do you do this moment?

>look
Bedroom
Your bed is perfectly made. Outside the window, you can see the sun setting on the Manhattan skyline, bleeding orange onto you. The living room lies to the north of your bedroom.

You can see a bed and a bedroom window here.

What do you do this moment?

>n
Living Room
Mostly bare, just the way you wanted it yesterday. An armchair sits dead center, facing the window.  The bedroom lies to the south.

You can see a living room window and an armchair here.

What do you do this moment?

>l
Living Room
Mostly bare, just the way you wanted it yesterday. An armchair sits dead center, facing the window.  The bedroom lies to the south.

You can see a living room window and an armchair here.

What do you do this moment?

>sit in chair
You touch the fabric of the chair, and memories of being with your family flood back to you. You sit down. The smoky smell reminds you of your grandfather, and the way he always smiled at you when you walked by. You lean back and close your eyes to take in a deep breath. Your grandfather passed when you were fifteen. It'll be your turn soon. 
You open your eyes and turn towards your room, wanting to look around.

You wanted this room earlier today. It reminds you of the emptiness of life, and your impending death. 
You just want to close your eyes and wait here.

What do you do this moment?

* * *

>l
Living Room (on the armchair)
Mostly bare, just the way you wanted it yesterday. An armchair sits dead center, facing the window.  The bedroom lies to the south.

You can see a living room window here.

What do you do this moment?

>z
Breathe, you tell yourself. In the silence, the clock ticks.

Time passes.

What do you do this moment?

* * *

>x clock
Your mother taught you how to read an analog clock; how 21st century she was. Do you remember how to read an analog clock?

>y
She was a good teacher, despite not being a good mother. 
You take a deep breath. Still, you miss her. Her laughter was contagious. Her love, although conditional, was abundant. She wouldn't want to see you like this. 

You miss her.

With your mother in your mind and heart, you're reminded that you have until seven o'clock tomorrow morning, when you, too, will pass and join her.

Well, time sure flies. The clock reads twenty-seven minutes past seven.

What do you do this moment?

>l
Living Room (on the armchair)
Mostly bare, but it's beginning to remind you of something. An armchair sits dead center, facing the window. The clock ticks, signaling the passage of time. The bedroom lies to the south.

You can see a clock and a living room window here.

What do you do this moment?

>ls
That's not a verb I recognise.

What do you do this moment?

I beg your pardon?

What do you do this moment?

>l
Living Room (on the armchair)
Mostly bare, but it's beginning to remind you of something. An armchair sits dead center, facing the window. The clock ticks, signaling the passage of time. The bedroom lies to the south.

You can see a clock and a living room window here.

What do you do this moment?

* * *

>z
You wait, patiently. 
Time passes.

What do you do this moment?

>x clock
Ah, time. For thousands of years, humankind worried about their limited lifespan. But no more. In the last century, the advancements in medicine have allowed wealthy people to streamline the ability to live forever. The layman's explanation? The cells are told to stop aging, and failed organs are replaced with artificial ones.
 
And it was a simple decision, really. 
You can remember the exact layout of your desk, years ago, when you made the decision. You turn around and see it just the way it was that day, in the corner of the room.
Well, time sure flies. The clock reads twelve minutes to nine.
What do you do this moment?

>x clock
Well, time sure flies. The clock reads five past nine.
What do you do this moment?

>x clock
Well, time sure flies. The clock reads eleven minutes to ten.
What do you do this moment?

>x clock
Life is composed of moments, unmeasurable by any clock.
Well, time sure flies. The clock reads one minute past ten.
What do you do this moment?

>x clock
Life is composed of moments, unmeasurable by any clock.
The more conscious we are of our time left, the less time we actually end up having. Well, time sure flies. The clock reads twenty-seven minutes to eleven.
What do you do this moment?

>l
Living Room (on the armchair)
The room is filled with the objects of your life. An armchair sits dead center, facing the window. The clock ticks, signaling the passage of time. The bedroom lies to the south.

You can see a desk (on which are a shredder (empty), a laptop and a letter), a clock and a living room window here.

What do you do this moment?

>x desk
A clear, wooden desk, popular back in the 2030's.  You picked it out when you first got your own place. It brings back so many memories.

On the desk are a shredder (empty), a laptop and a letter.

What do you do this moment?

* * *

>x laptop
An old laptop. It's a perfect replica of your university's Surface Air, and you're reminded how old you are when you realized it doesn't support air touch; instead, you can only tap it.

What do you do this moment?

>tap
What do you want to tap?

What do you do this moment?

>laptop
There's only one button to tap, and it reads "Sign Up Now." You should probably read what's on the laptop first, though.
Tap it?

>n
What do you do this moment?

>sign up
That's not a verb I recognise.

What do you do this moment?

>listen
You hear nothing besides the ticking of the clock.

What do you do this moment?

>l
Living Room (on the armchair)
The room is filled with the objects of your life. An armchair sits dead center, facing the window. The clock ticks, signaling the passage of time. The bedroom lies to the south.

You can see a desk (on which are a shredder (empty), a laptop and a letter), a clock and a living room window here.

What do you do this moment?

>touch laptop
There's only one button to tap, and it reads "Sign Up Now." You should probably read what's on the laptop first, though.
Tap it?

>yes
This is what you wanted. To live forever, so you can love forever, and never leave anyone behind. Your child, your grandchild, and your great-grandchild will never have to know loss. 

How wrong you were. Why did I click it? Here you are now, waiting out the last few moments of life. Intentionally waiting for someone to put you down, like a dog. You chuckle in the silence as tears stream down your face. 
This is the end. There's only one thing left for me to do here. It's already eleven minutes to twelve.

What do you do this moment?

* * *

>north
Living Room
Mostly bare, just the way you wanted it yesterday. An armchair sits dead center, facing the window. The bedroom lies to the south.

You can see a living room window and an armchair here.

What do you do this moment?

>south
Bedroom
Your bed is perfectly made. Outside the window, you can see the sun setting on the Manhattan skyline, bleeding orange onto you. The living room lies to the north of your bedroom.

You can see a bed and a bedroom window here.

What do you do this moment?

>window
That's not a verb I recognise.

What do you do this moment?

>bedroom window
That's not a verb I recognise.

What do you do this moment?

>look
Bedroom
Your bed is perfectly made. Outside the window, you can see the sun setting on the Manhattan skyline, bleeding orange onto you. The living room lies to the north of your bedroom.

You can see a bed and a bedroom window here.

What do you do this moment?

>examine window
Outside, Manhattan glitters gold beneath you. Everything is perfect.

What do you do this moment?

>north
Living Room
Mostly bare, just the way you wanted it yesterday. An armchair sits dead center, facing the window. The bedroom lies to the south.

You can see a living room window and an armchair here.

What do you do this moment?

>examine chair
It's a perfect replica of the same one your grandfather owned. It even smells of old cigarette smoke.

What do you do this moment?

>examine window
Outside, Manhattan glitters gold beneath you. Everything is perfect.

What do you do this moment?

>sit
What do you want to sit on?

What do you do this moment?

>armchair
You touch the fabric of the chair, and memories of being with your family flood back to you. You sit down. The smoky smell reminds you of your grandfather, and the way he always smiled at you when you walked by. You lean back and close your eyes to take in a deep breath. Your grandfather passed when you were fifteen. It'll be your turn soon. 
You open your eyes and turn towards your room, wanting to look around.

You wanted this room earlier today. It reminds you of the emptiness of life, and your impending death. 
You just want to close your eyes and wait here.

What do you do this moment?

>close eyes
Breathe, you tell yourself. In the silence, the clock ticks.

Time passes.

What do you do this moment?

>breathe
You wait, patiently.

Time passes.

What do you do this moment?

>breathe
You wait, patiently.

Time passes.

What do you do this moment?

>stand
You get off the armchair.

Living Room
Mostly bare, just the way you wanted it yesterday. An armchair sits dead center, facing the window. The bedroom lies to the south.

You can see a clock, a living room window and an armchair here.

What do you do this moment?

>clock
That's not a verb I recognise.

What do you do this moment?

>examine clock
Your mother taught you how to read an analog clock; how 21st century she was. Do you remember how to read an analog clock?

>yes
She was a good teacher, despite not being a good mother. 
You take a deep breath. Still, you miss her. Her laughter was contagious. Her love, although conditional, was abundant. She wouldn't want to see you like this. 

You miss her.

With your mother in your mind and heart, you're reminded that you have until seven o'clock tomorrow morning, when you, too, will pass and join her.

Well, time sure flies. The clock reads twelve minutes to seven.

What do you do this moment?

>breathe
You wait, patiently.

Time passes.

What do you do this moment?

>examine clock
Ah, time. For thousands of years, humankind worried about their limited lifespan. But no more. In the last century, the advancements in medicine have allowed wealthy people to streamline the ability to live forever. The layman's explanation? The cells are told to stop aging, and failed organs are replaced with artificial ones.
 
And it was a simple decision, really. 
You can remember the exact layout of your desk, years ago, when you made the decision. You turn around and see it just the way it was that day, in the corner of the room.
Well, time sure flies. The clock reads nineteen minutes past eight.
What do you do this moment?

>examine desk
A clear, wooden desk, popular back in the 2030's.  You picked it out when you first got your own place. It brings back so many memories.

On the desk are a shredder (empty), a laptop and a letter.

What do you do this moment?

>examine letter
Your wife's cursive handwriting is difficult to read. Despite having read it a million times, you want to read it again.

What do you do this moment?

>read letter
The letter reads:
"Babe, I love you. 
The words "I'm sorry" was scribbled out, but you can still see it underneath the ink marks. "Thank you. For everything. For all the loving moments." Continue?

>yes
"I'm sorry that I must leave you early. I'm sorry I must leave our child motherless early. But I know he will grow up to be amazing regardless; you certainly did." Continue?

>yes
"Still, Be his friend and his dad. Take him to the baseball games or buy him makeup; whatever he's into." Continue?

>yes
"Love him. Love him again. Love him twice, so he can feel my love, too."
The text becomes a blur as your eyes water and your hands shake.
Breathe. You don't want to keep reading. Continue?

>yes
Still, you wipe away the tears, and read on. "Lastly, mourn for me. Cry, punch, scream, write; whatever you need. 
Then move on." Continue?

>yes
"I will always love you; but please, move on. For yourself, for me, for our child. 
Forever yours. 
Your wife, 

Kate In-young Dessalegn."
Your legs give out beneath you, and you break down in tears. You just need a moment to be okay.

What do you do this moment?

>breathe
You wait, patiently.

Time passes.

Breathe, you tell yourself. You wipe away the tears, regain control of your legs and arms, and pull yourself up. You look at the letter in your hand.

What do you do this moment?

>tear letter
Are you sure you want to shred the letter?

>breathe
Please answer yes or no.

>breathe
Please answer yes or no.

>examine clock
Please answer yes or no.

>examine desk
Please answer yes or no.

>examine laptop
Please answer yes or no.

>tap
Please answer yes or no.

>tap laptop
Please answer yes or no.

>yes
Feeling betrayed, you shove the letter into the shredder. 
"Bbbbbbbbbshhhhhhzzzzzzzzzzzzzzzzzzzz," the shredder hummed.

The letter is now completely destroyed, just like it was before, when you first read it years ago.
How could she? You thought to yourself back then. She didn't even fight it; she just accepted her death, and let the illness take her. You turn to the laptop, and you remembered how you found yourself here.

What do you do this moment?

>end
That's not a verb I recognise.

What do you do this moment?

>end the game
That's not a verb I recognise.

What do you do this moment?

>south
Bedroom
Your bed is perfectly made. Outside the window, you can see the beautiful Manhattan skyline at night like a million stars. The living room lies to the north of your bedroom.

You can see a bed and a bedroom window here.

What do you do this moment?

>sleep
You aren't feeling especially drowsy.

What do you do this moment?

>breathe
You wait, patiently.

Time passes.

What do you do this moment?

>get on bed
You fall onto the bed, as it engulfs you. 
Ah. It's soft. You could stay here forever.

You get up again, though. There's a time and place for everything. But not now.

What do you do this moment?

>s
You can't go that way.

What do you do this moment?

>n
Living Room
Mostly bare, just the way you wanted it yesterday. An armchair sits dead center, facing the window. The bedroom lies to the south.

You can see a desk (on which are a shredder (in which is a shredded letter) and a laptop), a clock, a living room window and an armchair here.

What do you do this moment?

>tap laptop
There's only one button to tap, and it reads "Sign Up Now." You should probably read what's on the laptop first, though.
Tap it?

>y
This is what you wanted. To live forever, so you can love forever, and never leave anyone behind. Your child, your grandchild, and your great-grandchild will never have to know loss. 

How wrong you were. Why did I click it?Here you are now, waiting out the last few moments of life. Intentionally waiting for someone to put you down, like a dog. You chuckle in the silence.
This is what I've made so far - there is a specific action left, which can end the game. - Hung
What do you do this moment?

>s
Bedroom
Your bed is perfectly made. Outside the window, you can see the beautiful Manhattan skyline at night like a million stars. The living room lies to the north of your bedroom.

You can see a bed and a bedroom window here.

What do you do this moment?

>enter bed
You fall onto the bed, as it engulfs you. 
Ah. It's soft. You could stay here forever.
You close your eyes, realizing you didn't amount to much in your life. Just a victim of circumstance, you thought to yourself. You won't wake again.

    *** The End ***

Would you like to RESTART, RESTORE a saved game, QUIT or UNDO the last command?

>restart
Is this the real life?
Is this just fantasy?
Caught in a landslide
No escape from reality...
cw: suicide/euthanasia, possibly depression
we all Die
An Interactive Fiction by Hung Nguyen
Release 1 / Serial number 181101 / Inform 7 build 6M62 (I6/v6.33 lib 6/12N) SD

You mentally turn off Queen from playing in your head. 
It's old and overplayed, you thought to yourself and get out of bed.

Bedroom
Your bed is perfectly made. Outside the window, you can see the sun setting on the Manhattan skyline, bleeding orange onto you. The living room lies to the north of your bedroom.

You can see a bed and a bedroom window here.

What do you do this moment?

>tear bed
What do you do this moment?

>tear letter
You can't see any such thing.

What do you do this moment?

>kill yourself
You can't see any such thing.

What do you do this moment?

* * *

>kill yourself
You can't see any such thing.

What do you do this moment?

>kill
What do you want to kill?

What do you do this moment?

>myself
What do you do this moment?

* * *

>sleep
You don't quite think it's time yet."

What do you do this moment?

>sleep
You don't quite think it's time yet."

What do you do this moment?

>get in bed
You fall onto the bed, as it engulfs you. 
Ah. It's soft. You could stay here forever.

You get up again, though. There's a time and place for everything. But not now.

What do you do this moment?

>kill yourself
You can't see any such thing.

What do you do this moment?

* * *

>x clock
Your mother taught you how to read an analog clock; how 21st century she was. Do you remember how to read an analog clock?

>n
The memory of your mother makes your blood boil; she was never there for you. She was a terrible teacher, and an even worse mother. She stopped making dinner for the family when you were 6. She stopped picking you up from school when you were 9. She forgot your 13th birthday, and every birthday after that. 
    Breathe.
Her birth date is July 29th, 2003. 
    Breathe.
She's a Leo. Your grandfather was also a Leo. You miss him. 
    Breathe.
You regain some composure, as your mind wandered back to him.
With your grandfather in your mind and heart, you're reminded that you have until 7:00 am tomorrow, when you, too, will pass and join him.

Well, time sure flies. The clock reads 7:04 pm.

What do you do this moment?

>x clock
Ah, time. For thousands of years, humankind worried about their limited lifespan. But no more. In the last century, the advancements in medicine have allowed wealthy people to streamline the ability to live forever. The layman's explanation? The cells are told to stop aging, and failed organs are replaced with artificial ones.
 
And it was a simple decision, really. 
You can remember the exact layout of your desk, years ago, when you made the decision. You turn around and see it just the way it was that day, in the corner of the room.
Well, time sure flies. The clock reads 7:24 pm.
What do you do this moment?

>shred letter
That's not a verb I recognise.

What do you do this moment?

* * *

>jump in bed
You fall onto the bed, as it engulfs you. 
Ah. It's soft. You could stay here forever.

You get up again, though. There's a time and place for everything. But not now.

What do you do this moment?

>jump into bed
I only understood you as far as wanting to jump.

What do you do this moment?

>sit down
What do you want to sit down on?

What do you do this moment?

>jump in
What do you want to jump in ( to )?

What do you do this moment?

>bed
You fall onto the bed, as it engulfs you. 
Ah. It's soft. You could stay here forever.

You get up again, though. There's a time and place for everything. But not now.

What do you do this moment?

* * *

>jump into bed
I only understood you as far as wanting to jump.

What do you do this moment?

>jump on bed
You fall onto the bed, as it engulfs you. 
Ah. It's soft. You could stay here forever.

You get up again, though. There's a time and place for everything. But not now.

What do you do this moment?

>jump on
What do you want to jump on?

What do you do this moment?

>bed
You fall onto the bed, as it engulfs you. 
Ah. It's soft. You could stay here forever.

You get up again, though. There's a time and place for everything. But not now.

What do you do this moment?

>jump in
What do you want to jump in?

What do you do this moment?

>bed
You fall onto the bed, as it engulfs you. 
Ah. It's soft. You could stay here forever.

You get up again, though. There's a time and place for everything. But not now.

What do you do this moment?

>jump into bed
I only understood you as far as wanting to jump.

What do you do this moment?

* * *

>sink in bed
I didn't understand that sentence.

What do you do this moment?

>sink into
What do you want to sink into?

What do you do this moment?

>bed
You fall onto the bed, as it engulfs you. 
Ah. It's soft. You could stay here forever.

You get up again, though. There's a time and place for everything. But not now.

What do you do this moment?

>help
That's not a verb I recognise.

What do you do this moment?

>help
That's not a verb I recognise.

What do you do this moment?

>action
That's not a verb I recognise.

What do you do this moment?

>ACTIONS
Actions listing on.

What do you do this moment?

>s
[going south]
You can't go that way.
[going south - failed the can't go that way rule]

What do you do this moment?

>l
[looking]
Bedroom
Your bed is perfectly made. Outside the window, you can see the sun setting on the Manhattan skyline, bleeding orange onto you. The living room lies to the north of your bedroom.

You can see a bed and a bedroom window here.

[looking - succeeded]

What do you do this moment?

>jump
[jumping]
You jump on the spot.
[jumping - succeeded]

What do you do this moment?

>x self
[examining yourself]
You look down at yourself. You're wearing your best Sunday clothes, but it feels like wearing pajamas.
[examining yourself - ended without result]

What do you do this moment?

* * *

>look
Bedroom
Your bed is perfectly made. Outside the window, you can see the sun setting on the Manhattan skyline, bleeding orange onto you. The living room lies to the north of your bedroom.

You can see a bed and a bedroom window here.

What do you do this moment?

>look around
Bedroom
Your bed is perfectly made. Outside the window, you can see the sun setting on the Manhattan skyline, bleeding orange onto you. The living room lies to the north of your bedroom.

You can see a bed and a bedroom window here.

What do you do this moment?

>N
Living Room
Mostly bare, just the way you wanted it yesterday. An armchair sits dead center, facing the window.  The bedroom lies to the south.

You can see a living room window and an armchair here.

What do you do this moment?

* * *

>help
Common IF commands: 
 -E[x]amine thing e.g. "x table" or "examine table"
 -[L]ook e.g. "look"
 -[N]orth/[e]ast/[s]outh/[w]est e.g. "e"
  
There are other commands. Don't be afraid to try. Read carefully! There are other commands, so read carefully. If all else fails, don't be scared to find them through trial and error.

What do you do this moment?

>help
Common IF commands: 
-E[x]amine thing e.g. "x table"
-[L]ook e.g. "look"
-[N]orth/[e]ast/[s]outh/[w]est e.g. "e"
-There are other commands, so don't be scared to find them through trial and error.

What do you do this moment?

>e
You can't go that way.

What do you do this moment?

* * *

>help
Common IF commands: 
 -E[x]amine thing e.g. "x table" or "examine table"
 -[L]ook e.g. "look"
 -[N]orth/[e]ast/[s]outh/[w]est e.g. "e"
  
There are other commands. Don't be afraid to try. Read carefully! There are other commands, so read carefully. If all else fails, don't be scared to find them through trial and error.

What do you do this moment?

>n
Living Room
Mostly bare, just the way you wanted it yesterday. An armchair sits dead center, facing the window.  The bedroom lies to the south.

You can see a living room window and an armchair here.

What do you do this moment?

>sit in chair
You touch the fabric of the chair, and memories of being with your family flood back to you. You sit down. The smoky smell reminds you of your grandfather, and the way he always smiled at you when you walked by. You lean back and close your eyes to take in a deep breath. Your grandfather passed when you were fifteen. It'll be your turn soon. 
You open your eyes and turn towards your room, wanting to look around.

You wanted this room like this. It reminds you of the emptiness of life, and your impending death. 
You just want to close your eyes and wait here.

What do you do this moment?

>help
Common IF commands: 
 -E[x]amine thing e.g. "x table" or "examine table"
 -[L]ook e.g. "look"
 -[N]orth/[e]ast/[s]outh/[w]est e.g. "e"
 -[Z]/wait
 
There are other commands. Don't be afraid to try. Read carefully! There are other commands, so read carefully. If all else fails, don't be scared to find them through trial and error.

What do you do this moment?

>z
Breathe, you tell yourself. In the silence, the clock ticks.

Time passes.

What do you do this moment?

>wait
Breathe, you tell yourself. In the silence, the clock ticks.

Time passes.

What do you do this moment?

>wait
Breathe, you tell yourself. In the silence, the clock ticks.

Time passes.

What do you do this moment?

>ask
What do you want to ask yourself for?

What do you do this moment?

>cake
You can't see any such thing.

What do you do this moment?

>ask
What do you want to ask yourself for?

What do you do this moment?

>clock
You can't see any such thing.

What do you do this moment?

>x clock
Your mother taught you how to read an analog clock. 
How 21st century she was. 
Do you remember how to read an analog clock?

>n
The memory of your mother makes your blood boil; she was never there for you. She was a terrible teacher, and an even worse mother. She stopped making dinner for the family when you were 6. She stopped picking you up from school when you were 9. She forgot your 13th birthday, and every birthday after that. 
    Breathe.
Her birth date is July 29th, 2003. 
    Breathe.
She's a Leo. Your grandfather was also a Leo. You miss him. 
    Breathe.
You regain some composure, as your mind wandered back to him.
With your grandfather in your mind and heart, you're reminded that you have until 7:00 am tomorrow, when you, too, will pass and join him.

Well, time sure flies. The clock reads 7:28 pm.

What do you do this moment?

>breathe
You wait, patiently. 
Time passes.

What do you do this moment?

>breathe
You wait, patiently. 
Time passes.

What do you do this moment?

* * *

>fall on bed
You fall onto the bed, as it engulfs you. 
Ah. It's soft. You could stay here forever.

You get up again, though. There's a time and place for everything. But not now.

What do you do this moment?

>fall onto bed
You fall onto the bed, as it engulfs you. 
Ah. It's soft. You could stay here forever.

You get up again, though. There's a time and place for everything. But not now.

What do you do this moment?

>jump onto the bed
I only understood you as far as wanting to jump.

What do you do this moment?

>fall
What do you want to fall on?

What do you do this moment?

>bed
You fall onto the bed, as it engulfs you. 
Ah. It's soft. You could stay here forever.

You get up again, though. There's a time and place for everything. But not now.

What do you do this moment?

>see aroud
That's not a verb I recognise.

What do you do this moment?

>see around
That's not a verb I recognise.

What do you do this moment?

* * *

>see around
That's not a verb I recognise.

What do you do this moment?

>see around
That's not a verb I recognise.

What do you do this moment?

>see around
That's not a verb I recognise.
If you are new to interactive fiction, you may like to try typing "help."

What do you do this moment?

>see around
That's not a verb I recognise.
If you are new to interactive fiction, you may like to try typing "help."

What do you do this moment?

>help
Common IF commands: 
 -E[x]amine thing e.g. "x table" or "examine table"
 -[L]ook e.g. "look"
 -[N]orth/[e]ast/[s]outh/[w]est e.g. "e"
  
There are other commands. Don't be afraid to try. There are other commands, so read carefully. If all else fails, don't be scared to find them through trial and error.

What do you do this moment?

* * *

>I don't know
Common IF commands: 
 -E[x]amine thing e.g. "x table" or "examine table"
 -[L]ook e.g. "look"
 -[N]orth/[e]ast/[s]outh/[w]est e.g. "e"
  
There are other commands. Don't be afraid to try. There are other commands, so read carefully. If all else fails, don't be scared to find them through trial and error.

What do you do this moment?

>inhale
That's not a verb I recognise.

What do you do this moment?

>breathe
You inhale. Then exhale. 
You wait, patiently. 
Time passes.

What do you do this moment?

>n
Living Room
Mostly bare, just the way you wanted it yesterday. An armchair sits dead center, facing the window.  The bedroom lies to the south.

You can see a living room window and an armchair here.

What do you do this moment?

* * *

>x clock
You can't see any such thing.

What do you do this moment?

>z
Breathe, you tell yourself. In the silence, the clock ticks.

Time passes.

What do you do this moment?

* * *

>x clock
Your mother taught you how to read an analog clock. 
How 21st century she was. 
Do you remember how to read an analog clock?

>n
The memory of your mother makes your blood boil; she was never there for you. She was a terrible teacher, and an even worse mother. She stopped making dinner for the family when you were 6. She stopped picking you up from school when you were 9. She forgot your 13th birthday, and every birthday after that. 
    Breathe.
Her birth date is July 29th, 2003. 
    Breathe.
She's a Leo. Your grandfather was also a Leo. You miss him. 
    Breathe.
You regain some composure, as your mind wandered back to him.
With your grandfather in your mind and heart, you're reminded that you have until 7:00 am tomorrow, when you, too, will pass and join him.

Well, time sure flies. The clock reads 6:44 pm.

What do you do this moment?

>n
(first getting off the armchair)
You can't go that way.

What do you do this moment?

>x clock
Ah, time. For thousands of years, humankind worried about their limited lifespan. But no more. In the last century, the advancements in medicine have allowed wealthy people to streamline the ability to live forever. The layman's explanation? The cells are told to stop aging, and failed organs are replaced with artificial ones.
 
And it was a simple decision, really. 
 
You can remember the exact layout of your desk, years ago, when you made the decision. You turn around and see it just the way it was that day, in the corner of the room. Well, time sure flies. The clock reads 7:54 pm.
What do you do this moment?

>x clock
Well, time sure flies. The clock reads 8:33 pm.
What do you do this moment?

>x clock
Well, time sure flies. The clock reads 9:12 pm.
What do you do this moment?

>x clock
Life is composed of moments, unmeasurable by any clock.
Well, time sure flies. The clock reads 9:38 pm.
What do you do this moment?

>x clock
Life is composed of moments, unmeasurable by any clock.
The more conscious we are of our time left, the less time we actually end up having. Well, time sure flies. The clock reads 10:24 pm.
What do you do this moment?

>x clock
Life is composed of moments, unmeasurable by any clock.
The more conscious we are of our time left, the less time we actually end up having. Well, time sure flies. The clock reads 10:51 pm.
What do you do this moment?

>x clock
Life is composed of moments, unmeasurable by any clock.
The more conscious we are of our time left, the less time we actually end up having. Well, time sure flies. The clock reads 11:09 pm.
What do you do this moment?

>x clock
Life is composed of moments, unmeasurable by any clock.
The more conscious we are of our time left, the less time we actually end up having. Well, time sure flies. The clock reads 11:53 pm.
What do you do this moment?

>x clock
Life is composed of moments, unmeasurable by any clock.
The more conscious we are of our time left, the less time we actually end up having. Well, time sure flies. The clock reads 12:53 am.
What do you do this moment?

>x clock
Life is composed of moments, unmeasurable by any clock.
The more conscious we are of our time left, the less time we actually end up having. Well, time sure flies. The clock reads 1:28 am.
What do you do this moment?

>x clock
Life is composed of moments, unmeasurable by any clock.
The more conscious we are of our time left, the less time we actually end up having. Well, time sure flies. The clock reads 1:54 am.
What do you do this moment?

>x clock
Life is composed of moments, unmeasurable by any clock.
The more conscious we are of our time left, the less time we actually end up having. Well, time sure flies. The clock reads 2:49 am.
What do you do this moment?

I beg your pardon?
If you are new to interactive fiction, you may like to try typing "help."

What do you do this moment?

>x clock
Life is composed of moments, unmeasurable by any clock.
The more conscious we are of our time left, the less time we actually end up having. Well, time sure flies. The clock reads 3:14 am.
What do you do this moment?

>x clock
Life is composed of moments, unmeasurable by any clock.
The more conscious we are of our time left, the less time we actually end up having. Well, time sure flies. The clock reads 4:13 am.
What do you do this moment?

>x clock
Life is composed of moments, unmeasurable by any clock.
The more conscious we are of our time left, the less time we actually end up having. Well, time sure flies. The clock reads 4:24 am.
What do you do this moment?

>x clock
Life is composed of moments, unmeasurable by any clock.
The more conscious we are of our time left, the less time we actually end up having. Well, time sure flies. The clock reads 5:04 am.
What do you do this moment?

>x clock
Life is composed of moments, unmeasurable by any clock.
The more conscious we are of our time left, the less time we actually end up having. Well, time sure flies. The clock reads 5:20 am.
What do you do this moment?

>x clock
Life is composed of moments, unmeasurable by any clock.
The more conscious we are of our time left, the less time we actually end up having. Well, time sure flies. The clock reads 6:03 am.
What do you do this moment?

>x clock
Life is composed of moments, unmeasurable by any clock.
The more conscious we are of our time left, the less time we actually end up having. Well, time sure flies. The clock reads 6:25 am.
What do you do this moment?

>x clock
Life is composed of moments, unmeasurable by any clock.
The more conscious we are of our time left, the less time we actually end up having. Well, time sure flies. The clock reads 6:44 am.
What do you do this moment?

I beg your pardon?
If you are new to interactive fiction, you may like to try typing "help."

What do you do this moment?

>x clock
Life is composed of moments, unmeasurable by any clock.
The more conscious we are of our time left, the less time we actually end up having. Well, time sure flies. The clock reads 6:59 am.
What do you do this moment?

>x clock
Life is composed of moments, unmeasurable by any clock.
The more conscious we are of our time left, the less time we actually end up having. Well, time sure flies. The clock reads 7:00 am.
What do you do this moment?

>x clock
Life is composed of moments, unmeasurable by any clock.
The more conscious we are of our time left, the less time we actually end up having. Well, time sure flies. The clock reads 7:00 am.
What do you do this moment?

* * *

>die
You must supply a noun.

What do you do this moment?

>die
You must supply a noun.

What do you do this moment?

* * *

>de
That's not a verb I recognise.

What do you do this moment?

>die
You don't quite think it's time yet.

What do you do this moment?

>kill
(yourself)
You don't quite think it's time yet.

What do you do this moment?

>bed
That's not a verb I recognise.

What do you do this moment?

>kill
(yourself)
You don't quite think it's time yet.

What do you do this moment?

>kill yourself
You can't see any such thing.
If you are new to interactive fiction, you may like to try typing "help."

What do you do this moment?

>kill bed
You can only do that to something animate.
If you are new to interactive fiction, you may like to try typing "help."

What do you do this moment?

>n
Living Room
Mostly bare, just the way you wanted it yesterday. An armchair sits dead center, facing the window.  The bedroom lies to the south.

You can see a living room window and an armchair here.

What do you do this moment?

* * *

>sit in chair
You touch the fabric of the chair, and memories of being with your family flood back to you. You sit down. The smoky smell reminds you of your grandfather, and the way he always smiled at you when you walked by. You lean back and close your eyes to take in a deep breath. Your grandfather passed when you were fifteen. It'll be your turn soon. 
You open your eyes and turn towards your room, wanting to look around.

What do you do this moment?

>z
You inhale. Then exhale. 
You wait, patiently. 
Time passes.

What do you do this moment?

>l
You wanted this room like this. It reminds you of the emptiness of life, and your impending death. 
You just want to close your eyes and wait here.

What do you do this moment?

* * *

>x clock
Your mother taught you how to read an analog clock. 
How 21st century she was. 
Do you remember how to read an analog clock?

>n
The memory of your mother makes your blood boil; she was never there for you. She was a terrible teacher, and an even worse mother. She stopped making dinner for the family when you were 6. She stopped picking you up from school when you were 9. She forgot your 13th birthday, and every birthday after that. 
    Breathe.
Her birth date is July 29th, 2003. 
    Breathe.
She's a Leo. Your grandfather was also a Leo. You miss him. 
    Breathe.
You regain some composure, as your mind wandered back to him.
With your grandfather in your mind and heart, you're reminded that you have until 7:00 am tomorrow, when you, too, will pass and join him.

Well, time sure flies. The clock reads 7:16 pm.

What do you do this moment?

>l
Living Room (on the armchair)
Mostly bare, but it's beginning to remind you of something. An armchair sits dead center, facing the window. The clock ticks, signaling the passage of time. The bedroom lies to the south.

You can see a clock and a living room window here.

What do you do this moment?

>x clock
Ah, time. For thousands of years, humankind worried about their limited lifespan. But no more. In the last century, the advancements in medicine have allowed wealthy people to streamline the ability to live forever. The layman's explanation? The cells are told to stop aging, and failed organs are replaced with artificial ones.
 
And it was a simple decision, really. 
 
You can remember the exact layout of your desk, years ago, when you made the decision. You turn around and see it just the way it was that day, in the corner of the room. Well, time sure flies. The clock reads 7:42 pm.
What do you do this moment?

>shred letter
Are you sure you want to shred the letter?

>y
Feeling betrayed, you put the letter into the shredder. 
"Bbbbbbbbbshhhhhhzzzzzzzzzzzzzzzzzzzz," the shredder hummed.

The letter is now completely destroyed, just like it was before, when you first read it years ago.
How could she? You thought to yourself back then. She didn't even fight it; she just accepted her death, and let the illness take her. You turn to the laptop, and you remember how you found yourself here.

What do you do this moment?

>x letter
This is what's left of your letter.

What do you do this moment?

>l
Living Room (on the armchair)
Mostly bare, but it's beginning to remind you of something. An armchair sits dead center, facing the window. The clock ticks, signaling the passage of time. The bedroom lies to the south.

You can see a desk (on which are a shredder (in which is a shredded letter) and a laptop), a clock and a living room window here.

What do you do this moment?

>tap laptop
There's only one button to tap, and it reads "Sign Up Now." You should probably read what's on the laptop first, though. Sign up anyway?

>y
This is what you wanted. To live forever, so you can love forever, and never leave anyone behind. Your child, your grandchild, and your great-grandchild will never have to know loss. 

How wrong you were. You experienced loss. All they saw when they looked at you, was loss. Of a mother. Of a grandfather. Of a normal life.
Why did I click it? Here you are now, waiting out the last few moments of life. Intentionally waiting for someone to put you down, like a dog. You chuckle in the silence as tears stream down your face. 
This is the end. There's only one thing left for me to do here. It's already 8:05 pm.

What do you do this moment?

>s
(first getting off the armchair)

Bedroom
Your bed is perfectly made for you. Outside the window, you can see the beautiful Manhattan skyline at night like a million stars. The living room lies to the north of your bedroom.

You can see a bed and a bedroom window here.

What do you do this moment?

>get in bed
You fall onto the bed, as it engulfs you. 
Ah. It's soft. You could stay here forever.
You climb under the sheets, and tuck yourself in. You close your eyes, but only for a brief moment. You open your eyes to a large syringe of pentobarbital next to you. You reach for it and plunge it into your heart. You close your eyes while making sure the full dose enters your bloodstream. You won't wake again.

    *** The End ***

Would you like to RESTART, RESTORE a saved game, QUIT or UNDO the last command?

>restart
[cw: euthanasia, suicide/suicidal behavior, depression]

Is this the real life?
Is this just fantasy?
Caught in a landslide
No escape from reality...

The Clock Ticks for You
An Interactive Fiction by Hung Nguyen
Release 1 / Serial number 181205 / Inform 7 build 6M62 (I6/v6.33 lib 6/12N) SD

You mentally turn off Queen from playing in your head. 
It's old and overplayed, you thought to yourself and get out of bed.

Bedroom
Your bed is perfectly made. Outside the window, you can see the sun setting on the Manhattan skyline, bleeding orange onto you. The living room lies to the north of your bedroom.

You can see a bed and a bedroom window here.

What do you do this moment?

>n
Living Room
Mostly bare, just the way you wanted it yesterday. An armchair sits dead center, facing the window.  The bedroom lies to the south.

You can see a living room window and an armchair here.

What do you do this moment?

* * *

>x clock
Your mother taught you how to read an analog clock. 
How 21st century she was. 
Do you remember how to read an analog clock?

>y
She was a good teacher, despite not being a good mother. 
You take a deep breath. Still, you miss her. Her laughter was contagious. Her love, although conditional, was abundant. She wouldn't want to see you like this. 

You miss her.

With your mother in your mind and heart, you're reminded that you have until seven o'clock tomorrow morning, when you, too, will pass and join her.

Well, time sure flies. The clock reads two minutes to seven.

What do you do this moment?

>tap laptop
You can't see any such thing.

What do you do this moment?

>x clock
Ah, time. For thousands of years, humankind worried about their limited lifespan. But no more. In the last century, the advancements in medicine have allowed wealthy people to streamline the ability to live forever. The layman's explanation? The cells are told to stop aging, and failed organs are replaced with artificial ones.
 
And it was a simple decision, really. 
 
You can remember the exact layout of your desk, years ago, when you made the decision. You turn around and see it just the way it was that day, in the corner of the room. Well, time sure flies. The clock reads seven minutes to eight.
What do you do this moment?

>tap laptop
There's only one button to tap, and it reads "Sign Up Now." You should probably read what's on the laptop first, though. Sign up anyway?

>y
This is what you wanted. To live forever, so you can love forever, and never leave anyone behind. Your child, your grandchild, and your great-grandchild will never have to know loss. 

How wrong you were. They had to experience loss, because that makes them love more passionately. They had to experience loss, to appreciate what's around them. 
For you to appreciate what's around you.
Why did I click it? Here you are now, waiting out the last few moments of life. Intentionally waiting for someone to put you down, like a dog. You chuckle in the silence as tears stream down your face. 
This is the end. There's only one thing left for me to do here. It's already six minutes to eight.

What do you do this moment?